Geo_FIPS,Geo_QName,SE_T037_001,SE_T037_002,SE_T037_003,rate
1001,"Autauga County_AL",25970,23986,1984,0.076395841
1003,"Baldwin County_AL",92925,85953,6972,0.075028249
1005,"Barbour County_AL",10439,8597,1842,0.176453683
1007,"Bibb County_AL",9046,8294,752,0.083130665
1009,"Blount County_AL",24032,22189,1843,0.076689414
1011,"Bullock County_AL",4712,3865,847,0.17975382
1013,"Butler County_AL",8770,7813,957,0.109122007
1015,"Calhoun County_AL",54036,47401,6635,0.122788511
1017,"Chambers County_AL",15028,13689,1339,0.089100346
1019,"Cherokee County_AL",11026,10155,871,0.078995102
1021,"Chilton County_AL",19697,17895,1802,0.091486013
1023,"Choctaw County_AL",5097,4405,692,0.135766137
1025,"Clarke County_AL",10122,8161,1961,0.193736416
1027,"Clay County_AL",5715,5180,535,0.093613298
1029,"Cleburne County_AL",6614,6065,549,0.083005745
1031,"Coffee County_AL",22508,20912,1596,0.070908122
1033,"Colbert County_AL",23402,21290,2112,0.090248697
1035,"Conecuh County_AL",4802,3718,1084,0.225739275
1037,"Coosa County_AL",4642,3852,790,0.170185265
1039,"Covington County_AL",15996,14202,1794,0.112153038
1041,"Crenshaw County_AL",6226,5620,606,0.097333762
1043,"Cullman County_AL",34807,32282,2525,0.072542879
1045,"Dale County_AL",21030,18735,2295,0.109129815
1047,"Dallas County_AL",16856,14094,2762,0.163858567
1049,"DeKalb County_AL",30100,27778,2322,0.077142857
1051,"Elmore County_AL",36665,33636,3029,0.082612846
1053,"Escambia County_AL",14572,12294,2278,0.156327203
1055,"Etowah County_AL",45327,41236,4091,0.090255256
1057,"Fayette County_AL",6804,6122,682,0.100235156
1059,"Franklin County_AL",13574,12249,1325,0.097613084
1061,"Geneva County_AL",11732,10419,1313,0.111916127
1063,"Greene County_AL",3030,2412,618,0.203960396
1065,"Hale County_AL",6094,5282,812,0.133245816
1067,"Henry County_AL",7536,6922,614,0.081475584
1069,"Houston County_AL",48050,44067,3983,0.08289282
1071,"Jackson County_AL",23234,20883,2351,0.101187914
1073,"Jefferson County_AL",322632,293202,29430,0.091218478
1075,"Lamar County_AL",6001,5391,610,0.101649725
1077,"Lauderdale County_AL",42764,39734,3030,0.070853989
1079,"Lawrence County_AL",14077,12704,1373,0.097534986
1081,"Lee County_AL",73990,68614,5376,0.072658467
1083,"Limestone County_AL",40831,37664,3167,0.077563616
1085,"Lowndes County_AL",3998,3471,527,0.131815908
1087,"Macon County_AL",9132,7585,1547,0.169404293
1089,"Madison County_AL",179022,163753,15269,0.085291193
1091,"Marengo County_AL",7747,6860,887,0.114495934
1093,"Marion County_AL",12829,11560,1269,0.098916517
1095,"Marshall County_AL",41656,38140,3516,0.084405608
1097,"Mobile County_AL",189544,170900,18644,0.098362386
1099,"Monroe County_AL",8261,6551,1710,0.206996732
1101,"Montgomery County_AL",108775,99158,9617,0.088411859
1103,"Morgan County_AL",57156,51472,5684,0.099447127
1105,"Perry County_AL",3227,2865,362,0.112178494
1107,"Pickens County_AL",7784,6712,1072,0.137718397
1109,"Pike County_AL",16100,14462,1638,0.10173913
1111,"Randolph County_AL",9621,8630,991,0.103003846
1113,"Russell County_AL",25779,22927,2852,0.110632686
1115,"St. Clair County_AL",40350,36977,3373,0.083593556
1117,"Shelby County_AL",107205,101343,5862,0.054680285
1119,"Sumter County_AL",5310,4416,894,0.168361582
1121,"Talladega County_AL",35502,30618,4884,0.137569714
1123,"Tallapoosa County_AL",17408,15837,1571,0.090245864
1125,"Tuscaloosa County_AL",94880,87695,7185,0.075727234
1127,"Walker County_AL",27132,24043,3089,0.113850803
1129,"WA County_AL",7068,5656,1412,0.199773628
1131,"Wilcox County_AL",3582,2838,744,0.207705193
1133,"Winston County_AL",9843,8894,949,0.096413695
2013,"Aleutians East Borough_AK",2593,2519,74,0.028538373
2016,"Aleutians West Census Area_AK",3870,3787,83,0.021447028
2020,"Anchorage Municipality_AK",163294,152355,10939,0.066989602
2050,"Bethel Census Area_AK",7567,6232,1335,0.176423946
2060,"Bristol Bay Borough_AK",572,541,31,0.054195804
2068,"Denali Borough_AK",1239,1210,29,0.023405973
2070,"Dillingham Census Area_AK",2118,1854,264,0.124645892
2090,"Fairbanks North Star Borough_AK",50688,46661,4027,0.079446812
2100,"Haines Borough_AK",1516,1470,46,0.030343008
2105,"Hoonah-Angoon Census Area_AK",1250,1086,164,0.1312
2110,"Juneau City and Borough_AK",18818,17836,982,0.052184079
2122,"Kenai Peninsula Borough_AK",28290,25637,2653,0.09377872
2130,"Ketchikan Gateway Borough_AK",7227,6655,572,0.079147641
2150,"Kodiak Island Borough_AK",7502,7032,470,0.06264996
2158,"Kusilvak Census Area_AK",2894,2067,827,0.285763649
2164,"Lake and Peninsula Borough_AK",728,657,71,0.097527473
2170,"Matanuska-Susitna Borough_AK",45281,40854,4427,0.097767275
2180,"Nome Census Area_AK",4375,3654,721,0.1648
2185,"North Slope Borough_AK",6066,5499,567,0.09347181
2188,"Northwest Arctic Borough_AK",3320,2593,727,0.218975904
2195,"Petersburg Borough_AK",1817,1665,152,0.083654375
2198,"Prince of Wales-Hyder Census Area_AK",3273,2819,454,0.138710663
2220,"Sitka City and Borough_AK",4945,4756,189,0.038220425
2230,"Skagway Municipality_AK",733,676,57,0.077762619
2240,"Southeast Fairbanks Census Area_AK",3352,3038,314,0.093675418
2261,"Valdez-Cordova Census Area_AK",4944,4415,529,0.106998382
2275,"Wrangell City and Borough_AK",1176,1088,88,0.074829932
2282,"Yakutat City and Borough_AK",407,375,32,0.078624079
2290,"Yukon-Koyukuk Census Area_AK",2538,2077,461,0.181639086
4001,"Apache County_AZ",22404,18334,4070,0.181663989
4003,"Cochise County_AZ",47964,43776,4188,0.087315487
4005,"Coconino County_AZ",71083,64844,6239,0.087770634
4007,"Gila County_AZ",20607,17961,2646,0.12840297
4009,"Graham County_AZ",13913,11954,1959,0.140803565
4011,"Greenlee County_AZ",3718,3346,372,0.100053792
4012,"La Paz County_AZ",7189,6386,803,0.111698428
4013,"Maricopa County_AZ",1973499,1821038,152461,0.077254156
4015,"Mohave County_AZ",77050,66880,10170,0.131992213
4017,"Navajo County_AZ",39838,31955,7883,0.197876399
4019,"Pima County_AZ",469365,422371,46994,0.100122506
4021,"Pinal County_AZ",150122,134182,15940,0.106180307
4023,"Santa Cruz County_AZ",19452,17246,2206,0.113407362
4025,"Yavapai County_AZ",90527,81511,9016,0.099594596
4027,"Yuma County_AZ",82387,71622,10765,0.130663818
5001,"AR County_AR",8821,8088,733,0.083097155
5003,"Ashley County_AR",8886,7840,1046,0.117713257
5005,"Baxter County_AR",16484,15229,1255,0.076134433
5007,"Benton County_AR",114656,109788,4868,0.042457438
5009,"Boone County_AR",16784,15368,1416,0.084366063
5011,"Bradley County_AR",4612,4180,432,0.09366869
5013,"Calhoun County_AR",2417,2243,174,0.07199007
5015,"Carroll County_AR",12216,11454,762,0.06237721
5017,"Chicot County_AR",4258,3769,489,0.114842649
5019,"Clark County_AR",10679,9780,899,0.084183912
5021,"Clay County_AR",6942,6283,659,0.094929415
5023,"Cleburne County_AR",10805,9699,1106,0.102360019
5025,"Cleveland County_AR",3604,3256,348,0.096559378
5027,"Columbia County_AR",11673,10491,1182,0.101259316
5029,"Conway County_AR",9040,8306,734,0.08119469
5031,"Craighead County_AR",49197,45526,3671,0.074618371
5033,"Crawford County_AR",27241,25099,2142,0.078631475
5035,"Crittenden County_AR",22572,20336,2236,0.099060783
5037,"Cross County_AR",7815,7140,675,0.086372361
5039,"Dallas County_AR",3307,3031,276,0.083459329
5041,"Desha County_AR",5292,4355,937,0.177059713
5043,"Drew County_AR",8588,7361,1227,0.142873777
5045,"Faulkner County_AR",61174,57108,4066,0.066466146
5047,"Franklin County_AR",7406,6592,814,0.109910883
5049,"Fulton County_AR",4866,4498,368,0.075626798
5051,"Garland County_AR",43750,39729,4021,0.091908571
5053,"Grant County_AR",8396,7608,788,0.093854216
5055,"Greene County_AR",19407,17659,1748,0.090070593
5057,"Hempstead County_AR",9449,8699,750,0.079373479
5059,"Hot Spring County_AR",14380,13293,1087,0.075591099
5061,"Howard County_AR",6119,5596,523,0.085471482
5063,"Independence County_AR",16429,15303,1126,0.068537343
5065,"Izard County_AR",5118,4607,511,0.099843689
5067,"Jackson County_AR",6062,5585,477,0.078686902
5069,"Jefferson County_AR",31666,28119,3547,0.112012884
5071,"Johnson County_AR",11060,10376,684,0.061844485
5073,"Lafayette County_AR",2888,2527,361,0.125
5075,"Lawrence County_AR",7009,6527,482,0.068768726
5077,"Lee County_AR",3520,2910,610,0.173295455
5079,"Lincoln County_AR",4271,3666,605,0.141653009
5081,"Little River County_AR",5269,4805,464,0.088062251
5083,"Logan County_AR",9487,8718,769,0.08105829
5085,"Lonoke County_AR",33953,31944,2009,0.059170029
5087,"Madison County_AR",7286,6751,535,0.073428493
5089,"Marion County_AR",6377,5679,698,0.109455857
5091,"Miller County_AR",20395,18429,1966,0.096396176
5093,"MS County_AR",19512,17164,2348,0.120336203
5095,"Monroe County_AR",3229,2815,414,0.128213069
5097,"Montgomery County_AR",3799,3636,163,0.042906028
5099,"NV County_AR",3608,3265,343,0.095066519
5101,"Newton County_AR",3378,3228,150,0.044404973
5103,"Ouachita County_AR",11356,10415,941,0.082863684
5105,"Perry County_AR",4487,4184,303,0.067528415
5107,"Phillips County_AR",8462,6932,1530,0.18080832
5109,"Pike County_AR",4793,4476,317,0.066138118
5111,"Poinsett County_AR",10063,9053,1010,0.100367684
5113,"Polk County_AR",8212,7473,739,0.089990258
5115,"Pope County_AR",29677,27407,2270,0.076490211
5117,"Prairie County_AR",3744,3513,231,0.061698718
5119,"Pulaski County_AR",195070,180430,14640,0.075049982
5121,"Randolph County_AR",7098,6714,384,0.054099746
5123,"St. Francis County_AR",10488,9259,1229,0.117181541
5125,"Saline County_AR",56332,53363,2969,0.052705389
5127,"Scott County_AR",4772,4250,522,0.109388097
5129,"Searcy County_AR",3013,2836,177,0.058745436
5131,"Sebastian County_AR",58411,54852,3559,0.060930304
5133,"Sevier County_AR",7910,7173,737,0.093173198
5135,"Sharp County_AR",6318,5764,554,0.087685977
5137,"Stone County_AR",4658,4332,326,0.069987119
5139,"Union County_AR",18181,16418,1763,0.096969364
5141,"Van Buren County_AR",6168,5478,690,0.111867704
5143,"WA County_AR",109706,102944,6762,0.061637467
5145,"White County_AR",34791,32318,2473,0.071081602
5147,"Woodruff County_AR",2822,2472,350,0.124025514
5149,"Yell County_AR",9340,8567,773,0.082762313
6001,"Alameda County_CA",848232,778132,70100,0.082642485
6003,"Alpine County_CA",457,408,49,0.107221007
6005,"Amador County_CA",14621,12573,2048,0.140072498
6007,"Butte County_CA",101675,89411,12264,0.120619621
6009,"Calaveras County_CA",18475,16248,2227,0.120541272
6011,"Colusa County_CA",9860,8837,1023,0.103752535
6013,"Contra Costa County_CA",558915,509920,48995,0.087660914
6015,"Del Norte County_CA",9728,8612,1116,0.114720395
6017,"El Dorado County_CA",89493,79568,9925,0.110902529
6019,"Fresno County_CA",431701,374564,57137,0.13235318
6021,"Glenn County_CA",12041,10523,1518,0.126069263
6023,"Humboldt County_CA",65317,58449,6868,0.105148736
6025,"Imperial County_CA",70698,58391,12307,0.174078475
6027,"Inyo County_CA",8978,8370,608,0.067721096
6029,"Kern County_CA",374732,327294,47438,0.126591804
6031,"Kings County_CA",58562,50960,7602,0.12981114
6033,"Lake County_CA",26960,23011,3949,0.146476261
6035,"Lassen County_CA",10191,9082,1109,0.108821509
6037,"Los Angeles County_CA",5150589,4635465,515124,0.100012639
6039,"Madera County_CA",57312,53032,4280,0.07467895
6041,"Marin County_CA",136881,129027,7854,0.057378307
6043,"Mariposa County_CA",8292,7329,963,0.116136035
6045,"Mendocino County_CA",41955,36848,5107,0.121725658
6047,"Merced County_CA",114820,96170,18650,0.162428148
6049,"Modoc County_CA",3649,3334,315,0.086325021
6051,"Mono County_CA",8155,7061,1094,0.134150828
6053,"Monterey County_CA",193691,177333,16358,0.084454105
6055,"Napa County_CA",74168,68587,5581,0.075248085
6057,"NV County_CA",45997,41473,4524,0.09835424
6059,"Orange County_CA",1633526,1508753,124773,0.076382623
6061,"Placer County_CA",177378,162616,14762,0.083223399
6063,"Plumas County_CA",8489,7200,1289,0.151843562
6065,"Riverside County_CA",1056673,920603,136070,0.128772099
6067,"Sacramento County_CA",718801,633897,84904,0.118118923
6069,"San Benito County_CA",29897,26261,3636,0.121617554
6071,"San Bernardino County_CA",948728,829145,119583,0.126045611
6073,"San Diego County_CA",1601432,1462130,139302,0.086985898
6075,"San Francisco County_CA",513158,478373,34785,0.06778614
6077,"San Joaquin County_CA",325052,280460,44592,0.137184204
6079,"San Luis Obispo County_CA",133761,124997,8764,0.065519845
6081,"San Mateo County_CA",414738,387006,27732,0.066866311
6083,"Santa Barbara County_CA",221432,203616,17816,0.080458109
6085,"Santa Clara County_CA",991745,915619,76126,0.076759651
6087,"Santa Cruz County_CA",142187,131321,10866,0.076420489
6089,"Shasta County_CA",77226,69261,7965,0.103138839
6091,"Sierra County_CA",1206,1110,96,0.07960199
6093,"Siskiyou County_CA",18464,16127,2337,0.126570624
6095,"Solano County_CA",211021,187021,24000,0.113732756
6097,"Sonoma County_CA",261415,240247,21168,0.080974695
6099,"Stanislaus County_CA",245687,208428,37259,0.151652306
6101,"Sutter County_CA",43211,37520,5691,0.131702576
6103,"Tehama County_CA",26638,23127,3511,0.13180419
6105,"Trinity County_CA",5311,4832,479,0.090190171
6107,"Tulare County_CA",194102,170780,23322,0.120153321
6109,"Tuolumne County_CA",22355,19477,2878,0.128740774
6111,"Ventura County_CA",435709,398116,37593,0.086280063
6113,"Yolo County_CA",102031,92806,9225,0.090413698
6115,"Yuba County_CA",29923,25499,4424,0.147846138
8001,"Adams County_CO",249542,229743,19799,0.079341353
8003,"Alamosa County_CO",7015,6283,732,0.104347826
8005,"Arapahoe County_CO",335681,311498,24183,0.072041611
8007,"Archuleta County_CO",5999,5506,493,0.082180363
8009,"Baca County_CO",1783,1702,81,0.045429052
8011,"Bent County_CO",1321,1212,109,0.082513248
8013,"Boulder County_CO",177460,166701,10759,0.060627747
8014,"Broomfield County_CO",33657,31807,1850,0.054966277
8015,"Chaffee County_CO",8681,8170,511,0.058864186
8017,"Cheyenne County_CO",1028,932,96,0.093385214
8019,"Clear Creek County_CO",5404,5114,290,0.053663953
8021,"Conejos County_CO",3347,3021,326,0.097400657
8023,"Costilla County_CO",1442,1240,202,0.140083218
8025,"Crowley County_CO",1995,1457,538,0.269674185
8027,"Custer County_CO",1616,1390,226,0.139851485
8029,"Delta County_CO",12869,11362,1507,0.117103116
8031,"Denver County_CO",371912,348382,23530,0.063267655
8033,"Dolores County_CO",840,801,39,0.046428571
8035,"Douglas County_CO",166710,159911,6799,0.040783396
8037,"Eagle County_CO",33246,31793,1453,0.043704506
8039,"Elbert County_CO",13258,12373,885,0.06675215
8041,"El Paso County_CO",317205,290448,26757,0.08435239
8043,"Fremont County_CO",15395,13983,1412,0.09171809
8045,"Garfield County_CO",31244,29078,2166,0.06932531
8047,"Gilpin County_CO",3321,3159,162,0.048780488
8049,"Grand County_CO",8773,8274,499,0.056879061
8051,"Gunnison County_CO",9775,9016,759,0.077647059
8053,"Hinsdale County_CO",465,451,14,0.030107527
8055,"Huerfano County_CO",2601,2211,390,0.14994233
8057,"Jackson County_CO",776,764,12,0.015463918
8059,"Jefferson County_CO",312852,294390,18462,0.059011929
8061,"KIA County_CO",738,723,15,0.020325203
8063,"Kit Carson County_CO",3637,3421,216,0.059389607
8065,"Lake County_CO",4376,4126,250,0.057129799
8067,"La Plata County_CO",29502,27965,1537,0.052098163
8069,"Larimer County_CO",175790,164011,11779,0.067006087
8071,"Las Animas County_CO",6503,5903,600,0.092265108
8073,"Lincoln County_CO",1588,1488,100,0.062972292
8075,"Logan County_CO",11430,10407,1023,0.089501312
8077,"Mesa County_CO",74394,67956,6438,0.086539237
8079,"Mineral County_CO",314,309,5,0.015923567
8081,"Moffat County_CO",6738,6343,395,0.058622737
8083,"Montezuma County_CO",12240,11075,1165,0.095179739
8085,"Montrose County_CO",18740,16832,1908,0.101814301
8087,"Morgan County_CO",14135,13264,871,0.061620092
8089,"Otero County_CO",8193,7314,879,0.107286708
8091,"Ouray County_CO",2423,2261,162,0.066859265
8093,"Park County_CO",9347,8822,525,0.056167754
8095,"Phillips County_CO",2096,1984,112,0.053435115
8097,"Pitkin County_CO",11151,10290,861,0.077212806
8099,"Prowers County_CO",6080,5488,592,0.097368421
8101,"Pueblo County_CO",73205,65300,7905,0.107984427
8103,"Rio Blanco County_CO",3536,3389,147,0.041572398
8105,"Rio Grande County_CO",5539,5093,446,0.080519949
8107,"Routt County_CO",14653,14060,593,0.040469528
8109,"Saguache County_CO",2715,2452,263,0.096869245
8111,"San Juan County_CO",391,337,54,0.138107417
8113,"San Miguel County_CO",4760,4482,278,0.058403361
8115,"Sedgwick County_CO",1098,1028,70,0.063752277
8117,"Summit County_CO",19064,18171,893,0.046842216
8119,"Teller County_CO",12533,11501,1032,0.082342615
8121,"WA County_CO",2314,2196,118,0.05099395
8123,"Weld County_CO",138574,129395,9179,0.066238977
8125,"Yuma County_CO",5004,4878,126,0.025179856
9001,"Fairfield County_CT",509408,463610,45798,0.08990436
9003,"Hartford County_CT",485031,439719,45312,0.093420833
9005,"Litchfield County_CT",105827,98294,7533,0.071182212
9007,"Middlesex County_CT",93446,87871,5575,0.059660125
9009,"New Haven County_CT",464091,419901,44190,0.095218395
9011,"New London County_CT",144999,132990,12009,0.082821261
9013,"Tolland County_CT",86059,80190,5869,0.068197399
9015,"Windham County_CT",64848,58842,6006,0.09261658
10001,"Kent County_DE",82150,75246,6904,0.084041388
10003,"New Castle County_DE",289856,268331,21525,0.074261012
10005,"Sussex County_DE",98033,90239,7794,0.079503841
11001,"District of Columbia_District of Columbia",373626,337815,35811,0.095847184
12001,"Alachua County_FL",126608,116659,9949,0.078581132
12003,"Baker County_FL",11171,10174,997,0.089248948
12005,"Bay County_FL",85250,77894,7356,0.08628739
12007,"Bradford County_FL",10529,9225,1304,0.123848419
12009,"Brevard County_FL",257738,229693,28045,0.108812049
12011,"Broward County_FL",990423,890997,99426,0.10038741
12013,"Calhoun County_FL",5260,4735,525,0.099809886
12015,"Charlotte County_FL",63570,56730,6840,0.107597924
12017,"Citrus County_FL",50044,43486,6558,0.131044681
12019,"Clay County_FL",96673,86374,10299,0.106534399
12021,"Collier County_FL",152970,141106,11864,0.077557691
12023,"Columbia County_FL",29618,25226,4392,0.148288203
12027,"DeSoto County_FL",13549,12279,1270,0.093733855
12029,"Dixie County_FL",5291,4910,381,0.072009072
12031,"Duval County_FL",455106,409421,45685,0.100383207
12033,"Escambia County_FL",143857,130402,13455,0.093530381
12035,"Flagler County_FL",40728,36923,3805,0.093424671
12037,"Franklin County_FL",4780,4331,449,0.093933054
12039,"Gadsden County_FL",18845,16733,2112,0.112072168
12041,"Gilchrist County_FL",6988,6260,728,0.104178592
12043,"Glades County_FL",4247,3701,546,0.128561337
12045,"Gulf County_FL",6242,5604,638,0.10221083
12047,"Hamilton County_FL",4711,3966,745,0.158140522
12049,"Hardee County_FL",10691,9517,1174,0.109811991
12051,"Hendry County_FL",16714,14732,1982,0.118583224
12053,"Hernando County_FL",67603,58359,9244,0.136739494
12055,"Highlands County_FL",35895,31131,4764,0.132720435
12057,"Hillsborough County_FL",668998,608977,60021,0.089717757
12059,"Holmes County_FL",7229,6118,1111,0.15368654
12061,"Indian River County_FL",60581,53211,7370,0.121655304
12063,"Jackson County_FL",18001,15621,2380,0.132214877
12065,"Jefferson County_FL",5462,4946,516,0.09447089
12067,"Lafayette County_FL",3145,2685,460,0.146263911
12069,"Lake County_FL",134718,121642,13076,0.097062011
12071,"Lee County_FL",292753,263079,29674,0.101361899
12073,"Leon County_FL",157057,140338,16719,0.106451798
12075,"Levy County_FL",16198,14392,1806,0.111495246
12077,"Liberty County_FL",3059,2748,311,0.101667212
12079,"Madison County_FL",6962,6141,821,0.117925883
12081,"Manatee County_FL",153618,140416,13202,0.08594045
12083,"Marion County_FL",131149,115459,15690,0.119634919
12085,"Martin County_FL",67754,61157,6597,0.097366945
12086,"Miami-Dade County_FL",1338209,1204871,133338,0.099639145
12087,"Monroe County_FL",40974,38504,2470,0.06028213
12089,"Nassau County_FL",35040,31605,3435,0.098030822
12091,"Okaloosa County_FL",91152,84899,6253,0.068599702
12093,"Okeechobee County_FL",14993,13227,1766,0.117788301
12095,"Orange County_FL",664057,603683,60374,0.090916894
12097,"Osceola County_FL",145806,131450,14356,0.098459597
12099,"Palm Beach County_FL",682461,617902,64559,0.094597347
12101,"Pasco County_FL",206932,187556,19376,0.093634624
12103,"Pinellas County_FL",462270,423351,38919,0.084191057
12105,"Polk County_FL",275118,245853,29265,0.106372538
12107,"Putnam County_FL",27694,24209,3485,0.125839532
12109,"St. Johns County_FL",103328,96436,6892,0.066700217
12111,"St. Lucie County_FL",128141,112310,15831,0.123543597
12113,"Santa Rosa County_FL",73266,67510,5756,0.078563044
12115,"Sarasota County_FL",168793,155023,13770,0.081579212
12117,"Seminole County_FL",232315,210450,21865,0.0941179
12119,"Sumter County_FL",24490,22298,2192,0.089505921
12121,"Suwannee County_FL",17629,15676,1953,0.110783368
12123,"Taylor County_FL",7861,7155,706,0.089810457
12125,"Union County_FL",4477,3955,522,0.116595935
12127,"Volusia County_FL",219312,199287,20025,0.091308273
12129,"Wakulla County_FL",14225,12899,1326,0.093216169
12131,"Walton County_FL",27555,25377,2178,0.079041916
12133,"WA County_FL",9384,8307,1077,0.114769821
13001,"Appling County_GA",7681,7071,610,0.079416743
13003,"Atkinson County_GA",3654,3389,265,0.072523262
13005,"Bacon County_GA",4811,4598,213,0.04427354
13007,"Baker County_GA",1380,1282,98,0.071014493
13009,"Baldwin County_GA",17896,16387,1509,0.084320519
13011,"Banks County_GA",8522,7801,721,0.084604553
13013,"Barrow County_GA",35747,32137,3610,0.100987495
13015,"Bartow County_GA",48918,44594,4324,0.088392821
13017,"Ben Hill County_GA",6669,6019,650,0.097465887
13019,"Berrien County_GA",7489,6457,1032,0.13780211
13021,"Bibb County_GA",68622,60115,8507,0.12396899
13023,"Bleckley County_GA",4587,4365,222,0.048397646
13025,"Brantley County_GA",7521,6702,819,0.108895094
13027,"Brooks County_GA",6874,5703,1171,0.170352051
13029,"Bryan County_GA",15624,14224,1400,0.089605735
13031,"Bulloch County_GA",34259,31144,3115,0.090925012
13033,"Burke County_GA",9447,8676,771,0.081613211
13035,"Butts County_GA",9704,8700,1004,0.10346249
13037,"Calhoun County_GA",2207,2036,171,0.077480743
13039,"Camden County_GA",22606,20674,1932,0.085464036
13043,"Candler County_GA",4534,4168,366,0.080723423
13045,"Carroll County_GA",53892,47372,6520,0.120982706
13047,"Catoosa County_GA",32720,30069,2651,0.081020782
13049,"Charlton County_GA",5460,4705,755,0.138278388
13051,"Chatham County_GA",138090,124627,13463,0.097494388
13053,"Chattahoochee County_GA",2638,2204,434,0.164518575
13055,"Chattooga County_GA",9974,8976,998,0.100060156
13057,"Cherokee County_GA",117550,110111,7439,0.063283709
13059,"Clarke County_GA",59366,53922,5444,0.091702321
13061,"Clay County_GA",1049,848,201,0.191611058
13063,"Clayton County_GA",132924,114144,18780,0.141283741
13065,"Clinch County_GA",2587,2309,278,0.107460379
13067,"Cobb County_GA",398737,366793,31944,0.080112957
13069,"Coffee County_GA",16752,15358,1394,0.083213945
13071,"Colquitt County_GA",20013,18354,1659,0.082896118
13073,"Columbia County_GA",65577,60928,4649,0.070893758
13075,"Cook County_GA",7543,7043,500,0.066286623
13077,"Coweta County_GA",66970,62298,4672,0.06976258
13079,"Crawford County_GA",5444,4843,601,0.110396767
13081,"Crisp County_GA",10220,8633,1587,0.155283757
13083,"Dade County_GA",8354,7848,506,0.060569787
13085,"Dawson County_GA",10701,9787,914,0.085412578
13087,"Decatur County_GA",10578,9892,686,0.064851579
13089,"DeKalb County_GA",388735,344876,43859,0.112824932
13091,"Dodge County_GA",8723,7871,852,0.097672819
13093,"Dooly County_GA",5546,4895,651,0.117381897
13095,"Dougherty County_GA",41599,34097,7502,0.180340874
13097,"Douglas County_GA",69107,61844,7263,0.105097892
13099,"Early County_GA",4128,3742,386,0.093507752
13101,"Echols County_GA",1864,1675,189,0.10139485
13103,"Effingham County_GA",26965,25352,1613,0.059818283
13105,"Elbert County_GA",8083,7210,873,0.108004454
13107,"Emanuel County_GA",9559,8300,1259,0.131708338
13109,"Evans County_GA",4434,3979,455,0.102616148
13111,"Fannin County_GA",9848,8669,1179,0.11971974
13113,"Fayette County_GA",53913,49795,4118,0.07638232
13115,"Floyd County_GA",44531,39669,4862,0.109182367
13117,"Forsyth County_GA",98658,92504,6154,0.062377101
13119,"Franklin County_GA",8778,8038,740,0.084301663
13121,"Fulton County_GA",523844,471816,52028,0.099319645
13123,"Gilmer County_GA",12150,10938,1212,0.099753086
13125,"Glascock County_GA",1447,1344,103,0.071181755
13127,"Glynn County_GA",40106,36375,3731,0.093028475
13129,"Gordon County_GA",25735,23587,2148,0.083466097
13131,"Grady County_GA",10385,9291,1094,0.105344247
13133,"Greene County_GA",6388,5952,436,0.068252974
13135,"Gwinnett County_GA",447728,410562,37166,0.08301022
13137,"Habersham County_GA",18377,16970,1407,0.076563095
13139,"Hall County_GA",90978,84198,6780,0.074523511
13141,"Hancock County_GA",2528,2159,369,0.14596519
13143,"Haralson County_GA",12701,11136,1565,0.123218644
13145,"Harris County_GA",16376,15071,1305,0.07968979
13147,"Hart County_GA",10300,9660,640,0.062135922
13149,"Heard County_GA",5175,4547,628,0.121352657
13151,"Henry County_GA",103728,92993,10735,0.103491825
13153,"Houston County_GA",70886,64013,6873,0.096958497
13155,"Irwin County_GA",3388,3158,230,0.067886659
13157,"Jackson County_GA",28953,26679,2274,0.078541084
13159,"Jasper County_GA",6320,5520,800,0.126582278
13161,"Jeff Davis County_GA",6003,5606,397,0.0661336
13163,"Jefferson County_GA",6140,5097,1043,0.169869707
13165,"Jenkins County_GA",3382,3035,347,0.102602011
13167,"Johnson County_GA",4294,3909,385,0.089659991
13169,"Jones County_GA",13456,12176,1280,0.095124851
13171,"Lamar County_GA",8131,6860,1271,0.156315336
13173,"Lanier County_GA",4068,3476,592,0.145526057
13175,"Laurens County_GA",18113,16926,1187,0.065533043
13177,"Lee County_GA",13996,12990,1006,0.071877679
13179,"Liberty County_GA",26523,23102,3421,0.128982393
13181,"Lincoln County_GA",3440,3121,319,0.092732558
13183,"Long County_GA",6790,5728,1062,0.15640648
13185,"Lowndes County_GA",52378,45595,6783,0.129500936
13187,"Lumpkin County_GA",15447,14185,1262,0.081698712
13189,"McDuffie County_GA",9184,8314,870,0.094729965
13191,"McIntosh County_GA",5929,5410,519,0.087535841
13193,"Macon County_GA",5490,4461,1029,0.187431694
13195,"Madison County_GA",12473,11393,1080,0.086587028
13197,"Marion County_GA",3758,3219,539,0.143427355
13199,"Meriwether County_GA",8864,7730,1134,0.127933213
13201,"Miller County_GA",2538,2373,165,0.06501182
13205,"Mitchell County_GA",9203,7956,1247,0.135499294
13207,"Monroe County_GA",12200,10914,1286,0.105409836
13209,"Montgomery County_GA",3638,3394,244,0.067069819
13211,"Morgan County_GA",8188,7624,564,0.06888129
13213,"Murray County_GA",18087,16079,2008,0.111018964
13215,"Muscogee County_GA",88254,78531,9723,0.110170644
13217,"Newton County_GA",49487,43639,5848,0.118172449
13219,"Oconee County_GA",17074,16227,847,0.04960759
13221,"Oglethorpe County_GA",6713,6355,358,0.053329361
13223,"Paulding County_GA",76672,70001,6671,0.087006991
13225,"Peach County_GA",12948,11481,1467,0.113299351
13227,"Pickens County_GA",13825,12678,1147,0.082965642
13229,"Pierce County_GA",7970,7262,708,0.088833124
13231,"Pike County_GA",8176,7323,853,0.104329746
13233,"Polk County_GA",18035,16190,1845,0.102301081
13235,"Pulaski County_GA",4263,3949,314,0.073657049
13237,"Putnam County_GA",10078,9448,630,0.062512403
13239,"Quitman County_GA",848,753,95,0.112028302
13241,"Rabun County_GA",6726,6236,490,0.072851621
13243,"Randolph County_GA",2794,2503,291,0.104151754
13245,"Richmond County_GA",87252,76807,10445,0.119710723
13247,"Rockdale County_GA",42076,37374,4702,0.111750166
13249,"Schley County_GA",2243,1964,279,0.124386982
13251,"Screven County_GA",6079,5482,597,0.098206942
13253,"Seminole County_GA",3310,2999,311,0.093957704
13255,"Spalding County_GA",26793,23471,3322,0.123987609
13257,"Stephens County_GA",11441,10224,1217,0.106371821
13259,"Stewart County_GA",1736,1485,251,0.144585253
13261,"Sumter County_GA",13309,11392,1917,0.144037869
13263,"Talbot County_GA",2810,2513,297,0.10569395
13265,"Taliaferro County_GA",653,574,79,0.120980092
13267,"Tattnall County_GA",7938,7310,628,0.079113127
13269,"Taylor County_GA",3612,2869,743,0.205703212
13271,"Telfair County_GA",4676,4472,204,0.043627032
13273,"Terrell County_GA",3718,3181,537,0.144432491
13275,"Thomas County_GA",19400,17359,2041,0.105206186
13277,"Tift County_GA",17033,16038,995,0.058416016
13279,"Toombs County_GA",11744,10615,1129,0.096134196
13281,"Towns County_GA",4134,3722,412,0.099661345
13283,"Treutlen County_GA",2847,2692,155,0.054443274
13285,"Troup County_GA",32536,28677,3859,0.118607081
13287,"Turner County_GA",3313,2900,413,0.124660429
13289,"Twiggs County_GA",2767,2581,186,0.067220817
13291,"Union County_GA",8378,7291,1087,0.129744569
13293,"Upson County_GA",11145,9904,1241,0.111350381
13295,"Walker County_GA",30735,28164,2571,0.083650561
13297,"Walton County_GA",40768,37547,3221,0.079008046
13299,"Ware County_GA",14031,13022,1009,0.071912194
13301,"Warren County_GA",2389,1998,391,0.163666806
13303,"WA County_GA",8393,7370,1023,0.121887287
13305,"Wayne County_GA",11832,10495,1337,0.112998648
13307,"Webster County_GA",1209,1139,70,0.05789909
13309,"Wheeler County_GA",1487,1339,148,0.099529254
13311,"White County_GA",11830,11029,801,0.067709214
13313,"Whitfield County_GA",50556,45345,5211,0.103073819
13315,"Wilcox County_GA",2622,2446,176,0.067124333
13317,"Wilkes County_GA",4167,3798,369,0.088552916
13319,"Wilkinson County_GA",3547,3287,260,0.073301381
13321,"Worth County_GA",9266,8359,907,0.09788474
15001,"HI County_HI",89403,82124,7279,0.08141785
15003,"Honolulu County_HI",482523,455481,27042,0.056042924
15005,"Kalawao County_HI",64,64,0,0
15007,"Kauai County_HI",35925,33996,1929,0.053695198
15009,"Maui County_HI",87657,81619,6038,0.06888212
16001,"Ada County_ID",213995,199955,14040,0.06560901
16003,"Adams County_ID",1661,1474,187,0.112582781
16005,"Bannock County_ID",40081,37206,2875,0.071729747
16007,"Bear Lake County_ID",2687,2598,89,0.033122441
16009,"Benewah County_ID",4005,3600,405,0.101123596
16011,"Bingham County_ID",20585,19121,1464,0.071119747
16013,"Blaine County_ID",12446,11941,505,0.040575285
16015,"Boise County_ID",3092,2768,324,0.104786546
16017,"Bonner County_ID",17491,16399,1092,0.062432108
16019,"Bonneville County_ID",49999,47191,2808,0.056161123
16021,"Boundary County_ID",4079,3888,191,0.046825202
16023,"Butte County_ID",1030,960,70,0.067961165
16025,"Camas County_ID",531,500,31,0.058380414
16027,"Canyon County_ID",89911,81460,8451,0.093992949
16029,"Caribou County_ID",3168,3121,47,0.014835859
16031,"Cassia County_ID",10359,9771,588,0.056762236
16033,"Clark County_ID",460,442,18,0.039130435
16035,"Clearwater County_ID",3105,2877,228,0.073429952
16037,"Custer County_ID",1844,1784,60,0.032537961
16039,"Elmore County_ID",10897,9981,916,0.084059833
16041,"Franklin County_ID",5688,5401,287,0.050457103
16043,"Fremont County_ID",5641,5305,336,0.059563907
16045,"Gem County_ID",6749,5789,960,0.142243295
16047,"Gooding County_ID",7111,6844,267,0.037547462
16049,"ID County_ID",6971,6526,445,0.063835892
16051,"Jefferson County_ID",11876,11157,719,0.06054227
16053,"Jerome County_ID",10319,9641,678,0.065704041
16055,"Kootenai County_ID",70793,65216,5577,0.078778975
16057,"Latah County_ID",20383,18842,1541,0.075602218
16059,"Lemhi County_ID",3369,3165,204,0.060552093
16061,"Lewis County_ID",1654,1547,107,0.064691657
16063,"Lincoln County_ID",2353,2212,141,0.059923502
16065,"Madison County_ID",17988,16153,1835,0.102012453
16067,"Minidoka County_ID",9594,9136,458,0.04773817
16069,"Nez Perce County_ID",19874,18668,1206,0.060682298
16071,"Oneida County_ID",1874,1749,125,0.066702241
16073,"Owyhee County_ID",4875,4304,571,0.117128205
16075,"Payette County_ID",10447,9393,1054,0.100890208
16077,"Power County_ID",3514,3184,330,0.093910074
16079,"Shoshone County_ID",5663,4992,671,0.118488434
16081,"Teton County_ID",5836,5342,494,0.084647019
16083,"Twin Falls County_ID",38583,36316,2267,0.058756447
16085,"Valley County_ID",4550,4292,258,0.056703297
16087,"WA County_ID",4042,3650,392,0.096981692
17001,"Adams County_IL",34782,32400,2382,0.068483698
17003,"Alexander County_IL",2788,2400,388,0.139167862
17005,"Bond County_IL",8080,7563,517,0.063985149
17007,"Boone County_IL",27368,24714,2654,0.096974569
17009,"Brown County_IL",2931,2772,159,0.054247697
17011,"Bureau County_IL",17539,16206,1333,0.076002053
17013,"Calhoun County_IL",2358,2231,127,0.053859203
17015,"Carroll County_IL",7475,6866,609,0.081471572
17017,"Cass County_IL",6759,6183,576,0.085219707
17019,"Champaign County_IL",108763,101720,7043,0.064755478
17021,"Christian County_IL",16024,15151,873,0.054480779
17023,"Clark County_IL",8119,7425,694,0.085478507
17025,"Clay County_IL",6719,6270,449,0.06682542
17027,"Clinton County_IL",20241,19250,991,0.048960032
17029,"Coles County_IL",27620,24939,2681,0.097067343
17031,"Cook County_IL",2760232,2463655,296577,0.107446403
17033,"Crawford County_IL",8976,8369,607,0.067624777
17035,"Cumberland County_IL",5324,4932,392,0.07362885
17037,"DeKalb County_IL",57605,51637,5968,0.103602118
17039,"De Witt County_IL",8736,8066,670,0.076694139
17041,"Douglas County_IL",10023,9415,608,0.060660481
17043,"DuPage County_IL",515903,479592,36311,0.070383386
17045,"Edgar County_IL",8640,7807,833,0.096412037
17047,"Edwards County_IL",3235,2968,267,0.082534776
17049,"Effingham County_IL",18381,17382,999,0.0543496
17051,"Fayette County_IL",9979,8943,1036,0.103818018
17053,"Ford County_IL",6763,6179,584,0.086352211
17055,"Franklin County_IL",17241,15510,1731,0.100400209
17057,"Fulton County_IL",16896,15565,1331,0.078776042
17059,"Gallatin County_IL",2465,2280,185,0.07505071
17061,"Greene County_IL",6564,5944,620,0.094454601
17063,"Grundy County_IL",25920,23887,2033,0.078433642
17065,"Hamilton County_IL",3789,3618,171,0.045130641
17067,"Hancock County_IL",9227,8595,632,0.068494635
17069,"Hardin County_IL",1823,1493,330,0.181020296
17071,"Henderson County_IL",3602,3350,252,0.069961133
17073,"Henry County_IL",25002,23544,1458,0.058315335
17075,"Iroquois County_IL",14634,13533,1101,0.075235752
17077,"Jackson County_IL",28593,25623,2970,0.103871577
17079,"Jasper County_IL",4964,4691,273,0.054995971
17081,"Jefferson County_IL",18207,16528,1679,0.092217279
17083,"Jersey County_IL",11505,10587,918,0.079791395
17085,"Jo Daviess County_IL",11637,10991,646,0.055512589
17087,"Johnson County_IL",4731,4244,487,0.102938068
17089,"Kane County_IL",276540,255530,21010,0.075974543
17091,"Kankakee County_IL",55221,49815,5406,0.097897539
17093,"Kendall County_IL",65176,61270,3906,0.059930036
17095,"Knox County_IL",23183,21475,1708,0.073674675
17097,"Lake County_IL",368176,338959,29217,0.079356069
17099,"LaSalle County_IL",57063,51452,5611,0.098329916
17101,"Lawrence County_IL",4468,4197,271,0.060653536
17103,"Lee County_IL",16796,15539,1257,0.074839247
17105,"Livingston County_IL",17031,15954,1077,0.063237626
17107,"Logan County_IL",11769,10856,913,0.077576685
17109,"McDonough County_IL",15756,14279,1477,0.093742067
17111,"McHenry County_IL",170982,157226,13756,0.080452913
17113,"McLean County_IL",96111,90810,5301,0.055154977
17115,"Macon County_IL",54495,48783,5712,0.104816956
17117,"Macoupin County_IL",23344,21098,2246,0.09621316
17119,"Madison County_IL",137210,125030,12180,0.08876904
17121,"Marion County_IL",18868,17066,1802,0.095505618
17123,"Marshall County_IL",6044,5651,393,0.065023163
17125,"Mason County_IL",6843,6190,653,0.095425983
17127,"Massac County_IL",6380,5821,559,0.087617555
17129,"Menard County_IL",6628,6252,376,0.056729028
17131,"Mercer County_IL",8065,7568,497,0.061624303
17133,"Monroe County_IL",18050,17120,930,0.051523546
17135,"Montgomery County_IL",10153,9604,549,0.054072688
17137,"Morgan County_IL",17540,16089,1451,0.0827252
17139,"Moultrie County_IL",7321,6963,358,0.048900423
17141,"Ogle County_IL",27160,24989,2171,0.079933726
17143,"Peoria County_IL",93759,85639,8120,0.086605019
17145,"Perry County_IL",9036,8312,724,0.080123949
17147,"Piatt County_IL",9024,8451,573,0.06349734
17149,"Pike County_IL",7627,7197,430,0.056378655
17151,"Pope County_IL",1633,1469,164,0.100428659
17153,"Pulaski County_IL",2309,1935,374,0.161974881
17155,"Putnam County_IL",3138,2827,311,0.099107712
17157,"Randolph County_IL",14685,13698,987,0.06721144
17159,"Richland County_IL",7735,7317,418,0.054040078
17161,"Rock Island County_IL",74277,68438,5839,0.078611145
17163,"St. Clair County_IL",127881,116537,11344,0.08870747
17165,"Saline County_IL",11314,9841,1473,0.130192682
17167,"Sangamon County_IL",104365,96155,8210,0.07866622
17169,"Schuyler County_IL",3233,3062,171,0.052892051
17171,"Scott County_IL",2617,2370,247,0.094382881
17173,"Shelby County_IL",10547,9895,652,0.061818527
17175,"Stark County_IL",2769,2556,213,0.076923077
17177,"Stephenson County_IL",24246,21853,2393,0.098696692
17179,"Tazewell County_IL",68654,64883,3771,0.054927608
17181,"Union County_IL",7890,7339,551,0.069835234
17183,"Vermilion County_IL",36417,32514,3903,0.10717522
17185,"Wabash County_IL",6028,5501,527,0.087425348
17187,"Warren County_IL",8887,8068,819,0.092157083
17189,"WA County_IL",7612,7194,418,0.054913295
17191,"Wayne County_IL",7948,7523,425,0.053472572
17193,"White County_IL",6686,6095,591,0.088393658
17195,"Whiteside County_IL",28644,26336,2308,0.080575339
17197,"Will County_IL",361651,333433,28218,0.0780255
17199,"Williamson County_IL",31428,29214,2214,0.070446735
17201,"Winnebago County_IL",148195,131172,17023,0.114868923
17203,"Woodford County_IL",19971,18798,1173,0.058735166
18001,"Adams County_IN",15965,14982,983,0.061572189
18003,"Allen County_IN",185142,170294,14848,0.080197902
18005,"Bartholomew County_IN",40875,38666,2209,0.054042813
18007,"Benton County_IN",4327,4096,231,0.053385718
18009,"Blackford County_IN",5766,5199,567,0.098335068
18011,"Boone County_IN",31650,30471,1179,0.037251185
18013,"Brown County_IN",7505,7039,466,0.062091939
18015,"Carroll County_IN",10053,9224,829,0.082462946
18017,"Cass County_IN",18985,17342,1643,0.086542007
18019,"Clark County_IN",58775,54754,4021,0.068413441
18021,"Clay County_IN",12763,11766,997,0.07811643
18023,"Clinton County_IN",16186,15003,1183,0.073087854
18025,"Crawford County_IN",4575,4273,302,0.066010929
18027,"Daviess County_IN",15137,14319,818,0.05403977
18029,"Dearborn County_IN",26276,24159,2117,0.080567819
18031,"Decatur County_IN",13443,12601,842,0.062634829
18033,"DeKalb County_IN",21121,19542,1579,0.074759718
18035,"DE County_IN",57616,51781,5835,0.101273952
18037,"Dubois County_IN",22482,21742,740,0.032915221
18039,"Elkhart County_IN",98353,91085,7268,0.073897085
18041,"Fayette County_IN",10522,9245,1277,0.12136476
18043,"Floyd County_IN",39981,37064,2917,0.072959656
18045,"Fountain County_IN",8240,7533,707,0.085800971
18047,"Franklin County_IN",11857,11103,754,0.063591128
18049,"Fulton County_IN",9700,9122,578,0.059587629
18051,"Gibson County_IN",16733,16013,720,0.043028746
18053,"Grant County_IN",31969,29151,2818,0.088147893
18055,"Greene County_IN",15258,14187,1071,0.070192686
18057,"Hamilton County_IN",161119,154190,6929,0.04300548
18059,"Hancock County_IN",37404,35339,2065,0.055207999
18061,"Harrison County_IN",19869,18294,1575,0.079269213
18063,"Hendricks County_IN",81114,76792,4322,0.053283034
18065,"Henry County_IN",21803,19488,2315,0.106178049
18067,"Howard County_IN",39356,35740,3616,0.091879256
18069,"Huntington County_IN",19330,17909,1421,0.073512675
18071,"Jackson County_IN",21443,19885,1558,0.072657744
18073,"Jasper County_IN",16227,15197,1030,0.063474456
18075,"Jay County_IN",10343,9495,848,0.081987818
18077,"Jefferson County_IN",15832,14381,1451,0.091649823
18079,"Jennings County_IN",13604,12285,1319,0.096956777
18081,"Johnson County_IN",75410,70667,4743,0.062896168
18083,"Knox County_IN",19030,17864,1166,0.061271676
18085,"Kosciusko County_IN",40084,37483,2601,0.064888734
18087,"LaGrange County_IN",16578,15663,915,0.05519363
18089,"Lake County_IN",237413,212423,24990,0.105259611
18091,"LaPorte County_IN",51933,46864,5069,0.097606531
18093,"Lawrence County_IN",22061,20669,1392,0.063097774
18095,"Madison County_IN",60164,54576,5588,0.092879463
18097,"Marion County_IN",485872,436687,49185,0.101230365
18099,"Marshall County_IN",23403,21470,1933,0.082596248
18101,"Martin County_IN",5023,4716,307,0.061118853
18103,"Miami County_IN",16276,14752,1524,0.0936348
18105,"Monroe County_IN",75056,69887,5169,0.068868578
18107,"Montgomery County_IN",18799,17497,1302,0.069259003
18109,"Morgan County_IN",35300,32732,2568,0.072747875
18111,"Newton County_IN",6750,6146,604,0.089481481
18113,"Noble County_IN",23893,21795,2098,0.087808145
18115,"OH County_IN",3152,2909,243,0.077093909
18117,"Orange County_IN",8938,8330,608,0.068024166
18119,"Owen County_IN",10079,9276,803,0.079670602
18121,"Parke County_IN",7303,6730,573,0.078460906
18123,"Perry County_IN",8901,8399,502,0.056398158
18125,"Pike County_IN",6218,5902,316,0.050820199
18127,"Porter County_IN",84340,78219,6121,0.07257529
18129,"Posey County_IN",12775,12101,674,0.052759295
18131,"Pulaski County_IN",6270,5831,439,0.070015949
18133,"Putnam County_IN",16737,15518,1219,0.072832646
18135,"Randolph County_IN",12270,11319,951,0.077506112
18137,"Ripley County_IN",14135,13088,1047,0.074071454
18139,"Rush County_IN",8367,7787,580,0.069319947
18141,"St. Joseph County_IN",134636,123170,11466,0.085162958
18143,"Scott County_IN",11012,9803,1209,0.109789321
18145,"Shelby County_IN",23307,21379,1928,0.082721929
18147,"Spencer County_IN",10662,10060,602,0.056462202
18149,"Starke County_IN",10828,9583,1245,0.114979682
18151,"Steuben County_IN",17591,16375,1216,0.069126258
18153,"Sullivan County_IN",8801,8203,598,0.067946824
18155,"Switzerland County_IN",4772,4314,458,0.09597653
18157,"Tippecanoe County_IN",92693,86629,6064,0.065420258
18159,"Tipton County_IN",7669,7195,474,0.061807276
18161,"Union County_IN",3668,3384,284,0.07742639
18163,"Vanderburgh County_IN",91733,86077,5656,0.061657201
18165,"Vermillion County_IN",7151,6686,465,0.065025871
18167,"Vigo County_IN",51938,47334,4604,0.088644153
18169,"Wabash County_IN",16021,14892,1129,0.070470008
18171,"Warren County_IN",4267,4031,236,0.055308179
18173,"Warrick County_IN",31497,29930,1567,0.04975077
18175,"WA County_IN",13112,11783,1329,0.101357535
18177,"Wayne County_IN",31240,28437,2803,0.089724712
18179,"Wells County_IN",14089,13510,579,0.04109589
18181,"White County_IN",12158,11433,725,0.059631518
18183,"Whitley County_IN",17427,16503,924,0.053021174
19001,"Adair County_IA",3900,3776,124,0.031794872
19003,"Adams County_IA",2059,1994,65,0.031568723
19005,"Allamakee County_IA",7344,6904,440,0.059912854
19007,"Appanoose County_IA",6208,5799,409,0.065882732
19009,"Audubon County_IA",3087,3008,79,0.025591189
19011,"Benton County_IA",13730,13080,650,0.047341588
19013,"Black Hawk County_IA",71914,67141,4773,0.066370943
19015,"Boone County_IA",14066,13403,663,0.047134935
19017,"Bremer County_IA",13365,12843,522,0.039057239
19019,"Buchanan County_IA",10796,10375,421,0.038995924
19021,"Buena Vista County_IA",11138,10725,413,0.037080266
19023,"Butler County_IA",7726,7419,307,0.039735957
19025,"Calhoun County_IA",4804,4614,190,0.039550375
19027,"Carroll County_IA",11090,10722,368,0.033183048
19029,"Cass County_IA",6932,6712,220,0.031736872
19031,"Cedar County_IA",10066,9763,303,0.030101331
19033,"Cerro Gordo County_IA",23653,22601,1052,0.044476388
19035,"Cherokee County_IA",6248,6018,230,0.03681178
19037,"Chickasaw County_IA",6388,6148,240,0.037570445
19039,"Clarke County_IA",4742,4504,238,0.050189793
19041,"Clay County_IA",8841,8504,337,0.03811786
19043,"Clayton County_IA",9395,8996,399,0.042469399
19045,"Clinton County_IA",24745,23564,1181,0.047726813
19047,"Crawford County_IA",8604,8192,412,0.047884705
19049,"Dallas County_IA",41476,40388,1088,0.026232038
19051,"Davis County_IA",3989,3821,168,0.042115819
19053,"Decatur County_IA",3956,3660,296,0.074823054
19055,"DE County_IA",9798,9442,356,0.036333946
19057,"Des Moines County_IA",20070,18798,1272,0.063378176
19059,"Dickinson County_IA",9249,8899,350,0.037841929
19061,"Dubuque County_IA",52339,50102,2237,0.042740595
19063,"Emmet County_IA",5195,4955,240,0.046198268
19065,"Fayette County_IA",10588,10050,538,0.05081224
19067,"Floyd County_IA",8284,7998,286,0.034524384
19069,"Franklin County_IA",5234,5012,222,0.042414979
19071,"Fremont County_IA",3597,3463,134,0.037253267
19073,"Greene County_IA",4714,4452,262,0.055579126
19075,"Grundy County_IA",6412,6164,248,0.03867748
19077,"Guthrie County_IA",5614,5312,302,0.053794086
19079,"Hamilton County_IA",7775,7476,299,0.038456592
19081,"Hancock County_IA",5726,5640,86,0.015019211
19083,"Hardin County_IA",8723,8293,430,0.049294967
19085,"Harrison County_IA",7625,7352,273,0.035803279
19087,"Henry County_IA",9478,8992,486,0.051276641
19089,"Howard County_IA",4831,4666,165,0.034154419
19091,"Humboldt County_IA",4888,4652,236,0.048281506
19093,"Ida County_IA",3716,3579,137,0.0368676
19095,"IA County_IA",8983,8818,165,0.018368028
19097,"Jackson County_IA",10133,9687,446,0.044014606
19099,"Jasper County_IA",18230,17247,983,0.053922106
19101,"Jefferson County_IA",8277,7751,526,0.063549595
19103,"Johnson County_IA",81681,78838,2843,0.034806136
19105,"Jones County_IA",10333,9815,518,0.050130649
19107,"Keokuk County_IA",5184,4921,263,0.050733025
19109,"Kossuth County_IA",7959,7788,171,0.021485111
19111,"Lee County_IA",17981,16414,1567,0.087147545
19113,"Linn County_IA",119867,114142,5725,0.047761269
19115,"Louisa County_IA",5895,5614,281,0.047667515
19117,"Lucas County_IA",4375,4122,253,0.057828571
19119,"Lyon County_IA",6114,5968,146,0.023879621
19121,"Madison County_IA",8179,7712,467,0.057097445
19123,"Mahaska County_IA",11807,10859,948,0.080291353
19125,"Marion County_IA",17725,17020,705,0.03977433
19127,"Marshall County_IA",20722,19409,1313,0.06336261
19129,"Mills County_IA",7369,7089,280,0.037997015
19131,"Mitchell County_IA",5496,5319,177,0.03220524
19133,"Monona County_IA",4408,4165,243,0.055127042
19135,"Monroe County_IA",3817,3580,237,0.062090647
19137,"Montgomery County_IA",5154,4660,494,0.095847885
19139,"Muscatine County_IA",22239,21210,1029,0.046270066
19141,"O'Brien County_IA",7445,7237,208,0.027938214
19143,"Osceola County_IA",3393,3282,111,0.032714412
19145,"Page County_IA",7458,7075,383,0.05135425
19147,"Palo Alto County_IA",4776,4637,139,0.029103853
19149,"Plymouth County_IA",13440,12978,462,0.034375
19151,"Pocahontas County_IA",3664,3483,181,0.049399563
19153,"Polk County_IA",253512,238720,14792,0.058348323
19155,"Pottawattamie County_IA",48869,46439,2430,0.049724774
19157,"Poweshiek County_IA",10118,9636,482,0.047637873
19159,"Ringgold County_IA",2240,2133,107,0.047767857
19161,"Sac County_IA",5364,5151,213,0.039709172
19163,"Scott County_IA",87856,83140,4716,0.053678747
19165,"Shelby County_IA",6334,6153,181,0.028575939
19167,"Sioux County_IA",19207,18867,340,0.01770188
19169,"Story County_IA",53444,50519,2925,0.054730185
19171,"Tama County_IA",8779,8283,496,0.056498462
19173,"Taylor County_IA",3201,3061,140,0.043736332
19175,"Union County_IA",6747,6385,362,0.053653476
19177,"Van Buren County_IA",3539,3305,234,0.066120373
19179,"Wapello County_IA",17534,16128,1406,0.080187065
19181,"Warren County_IA",26269,25008,1261,0.04800335
19183,"WA County_IA",11851,11358,493,0.041599865
19185,"Wayne County_IA",2927,2800,127,0.043389136
19187,"Webster County_IA",18304,16774,1530,0.083588287
19189,"Winnebago County_IA",5559,5214,345,0.062061522
19191,"Winneshiek County_IA",12606,12230,376,0.029827066
19193,"Woodbury County_IA",54421,51599,2822,0.051854982
19195,"Worth County_IA",3986,3800,186,0.046663322
19197,"Wright County_IA",6356,5996,360,0.056639396
20001,"Allen County_KS",6301,5863,438,0.069512776
20003,"Anderson County_KS",3818,3593,225,0.058931378
20005,"Atchison County_KS",8111,7519,592,0.072987301
20007,"Barber County_KS",2425,2350,75,0.030927835
20009,"Barton County_KS",14161,13200,961,0.067862439
20011,"Bourbon County_KS",6767,6541,226,0.03339737
20013,"Brown County_KS",4822,4606,216,0.044794691
20015,"Butler County_KS",33118,31277,1841,0.055589106
20017,"Chase County_KS",1223,1187,36,0.029435814
20019,"Chautauqua County_KS",1591,1510,81,0.050911376
20021,"Cherokee County_KS",9959,9378,581,0.058339191
20023,"Cheyenne County_KS",1346,1321,25,0.018573551
20025,"Clark County_KS",1055,1040,15,0.014218009
20027,"Clay County_KS",4251,4169,82,0.019289579
20029,"Cloud County_KS",4841,4514,327,0.067548027
20031,"Coffey County_KS",4432,4207,225,0.050767148
20033,"Comanche County_KS",1052,995,57,0.05418251
20035,"Cowley County_KS",16868,15686,1182,0.070073512
20037,"Crawford County_KS",19752,18643,1109,0.056146213
20039,"Decatur County_KS",1444,1389,55,0.038088643
20041,"Dickinson County_KS",9537,8898,639,0.067002202
20043,"Doniphan County_KS",4023,3790,233,0.057916977
20045,"Douglas County_KS",65834,61881,3953,0.060044962
20047,"Edwards County_KS",1480,1451,29,0.019594595
20049,"Elk County_KS",1184,1121,63,0.053209459
20051,"Ellis County_KS",16805,16045,760,0.045224636
20053,"Ellsworth County_KS",2912,2787,125,0.042925824
20055,"Finney County_KS",19518,18612,906,0.04641869
20057,"Ford County_KS",17353,16237,1116,0.064311646
20059,"Franklin County_KS",13643,12701,942,0.069046397
20061,"Geary County_KS",14186,12884,1302,0.091780629
20063,"Gove County_KS",1394,1367,27,0.019368723
20065,"Graham County_KS",1313,1282,31,0.023610053
20067,"Grant County_KS",3901,3618,283,0.072545501
20069,"Gray County_KS",3278,3183,95,0.028981086
20071,"Greeley County_KS",605,592,13,0.021487603
20073,"Greenwood County_KS",2981,2876,105,0.03522308
20075,"Hamilton County_KS",1353,1322,31,0.022912047
20077,"Harper County_KS",2857,2750,107,0.037451873
20079,"Harvey County_KS",17236,16472,764,0.04432583
20081,"Haskell County_KS",2163,2078,85,0.039297272
20083,"Hodgeman County_KS",1031,1005,26,0.025218235
20085,"Jackson County_KS",6797,6496,301,0.044284243
20087,"Jefferson County_KS",9951,9264,687,0.069038288
20089,"Jewell County_KS",1506,1468,38,0.025232404
20091,"Johnson County_KS",316811,302532,14279,0.045071036
20093,"Kearny County_KS",1965,1930,35,0.017811705
20095,"Kingman County_KS",3722,3509,213,0.057227297
20097,"KIA County_KS",1370,1315,55,0.040145985
20099,"Labette County_KS",10113,9572,541,0.053495501
20101,"Lane County_KS",949,926,23,0.024236038
20103,"Leavenworth County_KS",35620,33513,2107,0.059152162
20105,"Lincoln County_KS",1601,1497,104,0.0649594
20107,"Linn County_KS",4349,3987,362,0.083237526
20109,"Logan County_KS",1456,1399,57,0.039148352
20111,"Lyon County_KS",18082,16784,1298,0.071784095
20113,"McPherson County_KS",15907,15406,501,0.031495568
20115,"Marion County_KS",6127,5820,307,0.050106088
20117,"Marshall County_KS",5087,4933,154,0.030273246
20119,"Meade County_KS",2199,2137,62,0.028194634
20121,"Miami County_KS",16982,16030,952,0.056059357
20123,"Mitchell County_KS",3169,3086,83,0.026191228
20125,"Montgomery County_KS",15904,14514,1390,0.087399396
20127,"Morris County_KS",2913,2819,94,0.032269138
20129,"Morton County_KS",1494,1408,86,0.057563588
20131,"Nemaha County_KS",5392,5302,90,0.016691395
20133,"Neosho County_KS",8202,7816,386,0.047061692
20135,"Ness County_KS",1567,1524,43,0.02744097
20137,"Norton County_KS",2696,2650,46,0.017062315
20139,"Osage County_KS",7915,7264,651,0.082248895
20141,"Osborne County_KS",1962,1884,78,0.039755352
20143,"Ottawa County_KS",3178,3008,170,0.053492763
20145,"Pawnee County_KS",3069,3012,57,0.018572825
20147,"Phillips County_KS",2869,2746,123,0.042872081
20149,"Pottawatomie County_KS",11207,10795,412,0.036762738
20151,"Pratt County_KS",4890,4618,272,0.055623722
20153,"Rawlins County_KS",1277,1247,30,0.023492561
20155,"Reno County_KS",31364,29564,1800,0.057390639
20157,"Republic County_KS",2553,2455,98,0.038386212
20159,"Rice County_KS",5192,4905,287,0.05527735
20161,"Riley County_KS",36284,34186,2098,0.057821629
20163,"Rooks County_KS",2738,2626,112,0.040905771
20165,"Rush County_KS",1670,1577,93,0.055688623
20167,"Russell County_KS",3718,3463,255,0.068585261
20169,"Saline County_KS",29790,28311,1479,0.049647533
20171,"Scott County_KS",2775,2613,162,0.058378378
20173,"Sedgwick County_KS",256902,239060,17842,0.069450608
20175,"Seward County_KS",12122,11031,1091,0.09000165
20177,"Shawnee County_KS",90323,84199,6124,0.067801114
20179,"Sheridan County_KS",1302,1286,16,0.012288786
20181,"Sherman County_KS",3117,2992,125,0.040102663
20183,"Smith County_KS",1897,1836,61,0.032156036
20185,"Stafford County_KS",2164,2108,56,0.025878004
20187,"Stanton County_KS",1143,1116,27,0.023622047
20189,"Stevens County_KS",2778,2696,82,0.029517639
20191,"Sumner County_KS",11566,10758,808,0.069859934
20193,"Thomas County_KS",4497,4376,121,0.026906827
20195,"Trego County_KS",1701,1684,17,0.009994121
20197,"Wabaunsee County_KS",3511,3295,216,0.061520934
20199,"Wallace County_KS",798,755,43,0.053884712
20201,"WA County_KS",3045,2950,95,0.031198686
20203,"Wichita County_KS",1112,1077,35,0.03147482
20205,"Wilson County_KS",4333,4052,281,0.064851142
20207,"Woodson County_KS",1632,1557,75,0.045955882
20209,"Wyandotte County_KS",79402,70518,8884,0.11188635
21001,"Adair County_KY",8342,7700,642,0.076959962
21003,"Allen County_KY",9443,8576,867,0.091814042
21005,"Anderson County_KY",11435,10646,789,0.068998688
21007,"Ballard County_KY",3719,3489,230,0.061844582
21009,"Barren County_KY",20209,18672,1537,0.076055223
21011,"Bath County_KY",4705,4045,660,0.140276302
21013,"Bell County_KY",9071,8018,1053,0.116084224
21015,"Boone County_KY",66346,62624,3722,0.05609984
21017,"Bourbon County_KY",9968,8984,984,0.098715891
21019,"Boyd County_KY",20526,18376,2150,0.104745201
21021,"Boyle County_KY",13158,12218,940,0.071439428
21023,"Bracken County_KY",3803,3486,317,0.083355246
21025,"Breathitt County_KY",4841,4239,602,0.124354472
21027,"Breckinridge County_KY",8679,7683,996,0.114759765
21029,"Bullitt County_KY",40126,37079,3047,0.075935802
21031,"Butler County_KY",5330,5003,327,0.061350844
21033,"Caldwell County_KY",5912,5396,516,0.087280108
21035,"Calloway County_KY",18603,16904,1699,0.091329355
21037,"Campbell County_KY",49211,45872,3339,0.067850684
21039,"Carlisle County_KY",2277,2122,155,0.068072025
21041,"Carroll County_KY",4911,4263,648,0.131948687
21043,"Carter County_KY",11297,10039,1258,0.111356997
21045,"Casey County_KY",6511,5926,585,0.08984795
21047,"Christian County_KY",27341,23856,3485,0.127464248
21049,"Clark County_KY",17314,15950,1364,0.078780178
21051,"Clay County_KY",6490,5459,1031,0.158859784
21053,"Clinton County_KY",3919,3555,364,0.092880837
21055,"Crittenden County_KY",3925,3645,280,0.07133758
21057,"Cumberland County_KY",2728,2449,279,0.102272727
21059,"Daviess County_KY",47151,43941,3210,0.06807915
21061,"Edmonson County_KY",5193,4730,463,0.089158483
21063,"Elliott County_KY",2227,2088,139,0.062415806
21065,"Estill County_KY",5505,4855,650,0.118074478
21067,"Fayette County_KY",168794,157198,11596,0.068699124
21069,"Fleming County_KY",6533,5897,636,0.097351906
21071,"Floyd County_KY",13206,11922,1284,0.097228532
21073,"Franklin County_KY",24765,22601,2164,0.087381385
21075,"Fulton County_KY",2585,2274,311,0.120309478
21077,"Gallatin County_KY",4063,3821,242,0.0595619
21079,"Garrard County_KY",8053,7138,915,0.113622253
21081,"Grant County_KY",10961,10215,746,0.068059484
21083,"Graves County_KY",17071,15840,1231,0.072110597
21085,"Grayson County_KY",11398,10342,1056,0.092647833
21087,"Green County_KY",4902,4459,443,0.090371277
21089,"Greenup County_KY",15023,13500,1523,0.101377887
21091,"Hancock County_KY",3874,3647,227,0.058595767
21093,"Hardin County_KY",50097,46001,4096,0.081761383
21095,"Harlan County_KY",9080,8189,891,0.098127753
21097,"Harrison County_KY",7950,7303,647,0.081383648
21099,"Hart County_KY",7699,6958,741,0.096246266
21101,"Henderson County_KY",22099,20337,1762,0.079732115
21103,"Henry County_KY",7604,7099,505,0.066412415
21105,"Hickman County_KY",1911,1742,169,0.088435374
21107,"Hopkins County_KY",20775,19388,1387,0.066762936
21109,"Jackson County_KY",4554,3993,561,0.123188406
21111,"Jefferson County_KY",394720,361510,33210,0.08413559
21113,"Jessamine County_KY",25325,23096,2229,0.088015795
21115,"Johnson County_KY",7853,7136,717,0.091302687
21117,"Kenton County_KY",86096,79447,6649,0.077227746
21119,"Knott County_KY",5570,4755,815,0.146319569
21121,"Knox County_KY",11245,9477,1768,0.157225434
21123,"Larue County_KY",6366,5771,595,0.093465284
21125,"Laurel County_KY",25203,22079,3124,0.123953498
21127,"Lawrence County_KY",5822,5366,456,0.0783236
21129,"Lee County_KY",1930,1694,236,0.122279793
21131,"Leslie County_KY",3394,2816,578,0.17030053
21133,"Letcher County_KY",8327,7281,1046,0.125615468
21135,"Lewis County_KY",5069,4643,426,0.084040245
21137,"Lincoln County_KY",10280,9202,1078,0.104863813
21139,"Livingston County_KY",4114,3840,274,0.066601847
21141,"Logan County_KY",11348,10471,877,0.077282341
21143,"Lyon County_KY",2874,2655,219,0.076200418
21145,"McCracken County_KY",30929,29043,1886,0.06097837
21147,"McCreary County_KY",5402,4377,1025,0.189744539
21149,"McLean County_KY",4300,3938,362,0.084186047
21151,"Madison County_KY",43162,39435,3727,0.086349103
21153,"Magoffin County_KY",4173,3663,510,0.122214234
21155,"Marion County_KY",8607,7818,789,0.091669571
21157,"Marshall County_KY",14144,13051,1093,0.077276584
21159,"Martin County_KY",3080,2445,635,0.206168831
21161,"Mason County_KY",7600,7127,473,0.062236842
21163,"Meade County_KY",12775,11311,1464,0.114598826
21165,"Menifee County_KY",2579,2200,379,0.146956185
21167,"Mercer County_KY",10538,9331,1207,0.114537863
21169,"Metcalfe County_KY",4335,4014,321,0.074048443
21171,"Monroe County_KY",4355,3943,412,0.094603904
21173,"Montgomery County_KY",12214,10948,1266,0.103651547
21175,"Morgan County_KY",4141,3744,397,0.095870563
21177,"Muhlenberg County_KY",12864,11534,1330,0.103389303
21179,"Nelson County_KY",22440,20232,2208,0.098395722
21181,"Nicholas County_KY",3117,2877,240,0.076997113
21183,"OH County_KY",9850,8906,944,0.095837563
21185,"Oldham County_KY",30625,29304,1321,0.043134694
21187,"Owen County_KY",4761,4351,410,0.086116362
21189,"Owsley County_KY",1328,1211,117,0.08810241
21191,"Pendleton County_KY",6949,6507,442,0.063606274
21193,"Perry County_KY",10876,9364,1512,0.139021699
21195,"Pike County_KY",23359,20861,2498,0.106939509
21197,"Powell County_KY",4753,4360,393,0.08268462
21199,"Pulaski County_KY",28237,25669,2568,0.090944505
21201,"Robertson County_KY",864,806,58,0.06712963
21203,"Rockcastle County_KY",6756,6015,741,0.109680284
21205,"Rowan County_KY",10718,10022,696,0.064937488
21207,"Russell County_KY",6819,6014,805,0.1180525
21209,"Scott County_KY",26959,25105,1854,0.068771097
21211,"Shelby County_KY",22388,21103,1285,0.05739682
21213,"Simpson County_KY",8094,7524,570,0.070422535
21215,"Spencer County_KY",9283,8691,592,0.063772487
21217,"Taylor County_KY",11498,10395,1103,0.095929727
21219,"Todd County_KY",5078,4648,430,0.084679007
21221,"Trigg County_KY",6096,5584,512,0.083989501
21223,"Trimble County_KY",4212,3598,614,0.145773979
21225,"Union County_KY",6599,6085,514,0.077890589
21227,"Warren County_KY",61647,56780,4867,0.078949503
21229,"WA County_KY",5824,5468,356,0.061126374
21231,"Wayne County_KY",7648,6681,967,0.126438285
21233,"Webster County_KY",5591,5186,405,0.072437847
21235,"Whitley County_KY",13811,12406,1405,0.101730505
21237,"Wolfe County_KY",2178,1967,211,0.09687787
21239,"Woodford County_KY",13384,12748,636,0.047519426
22001,"Acadia Parish_LA",27380,24619,2761,0.100840029
22003,"Allen Parish_LA",9073,8269,804,0.088614571
22005,"Ascension Parish_LA",59139,55380,3759,0.063562116
22007,"Assumption Parish_LA",10487,9407,1080,0.102984648
22009,"Avoyelles Parish_LA",16596,14998,1598,0.096288262
22011,"Beauregard Parish_LA",15155,14287,868,0.057274827
22013,"Bienville Parish_LA",5760,5177,583,0.101215278
22015,"Bossier Parish_LA",59997,56570,3427,0.057119523
22017,"Caddo Parish_LA",116873,108738,8135,0.069605469
22019,"Calcasieu Parish_LA",94684,86840,7844,0.082843986
22021,"Caldwell Parish_LA",4406,3955,451,0.102360418
22023,"Cameron Parish_LA",3283,3077,206,0.062747487
22025,"Catahoula Parish_LA",4089,3749,340,0.083149914
22027,"Claiborne Parish_LA",6354,5494,860,0.135347812
22029,"Concordia Parish_LA",8015,7078,937,0.116905802
22031,"De Soto Parish_LA",11604,10521,1083,0.093329886
22033,"East Baton Rouge Parish_LA",233123,215513,17610,0.075539522
22035,"East Carroll Parish_LA",2329,1882,447,0.191927866
22037,"East Feliciana Parish_LA",7665,7165,500,0.065231572
22039,"Evangeline Parish_LA",12254,10978,1276,0.104129264
22041,"Franklin Parish_LA",7977,7062,915,0.114704776
22043,"Grant Parish_LA",7785,7068,717,0.092100193
22045,"Iberia Parish_LA",35266,31517,3749,0.106306357
22047,"Iberville Parish_LA",14175,13049,1126,0.079435626
22049,"Jackson Parish_LA",5944,5536,408,0.068640646
22051,"Jefferson Parish_LA",225344,210346,14998,0.066556021
22053,"Jefferson Davis Parish_LA",13937,12657,1280,0.09184186
22055,"Lafayette Parish_LA",124344,116522,7822,0.062906131
22057,"Lafourche Parish_LA",46840,43542,3298,0.070409906
22059,"LaSalle Parish_LA",5714,5354,360,0.06300315
22061,"Lincoln Parish_LA",23308,20541,2767,0.118714604
22063,"Livingston Parish_LA",66254,61631,4623,0.069776919
22065,"Madison Parish_LA",4773,3967,806,0.168866541
22067,"Morehouse Parish_LA",10751,9888,863,0.080271603
22069,"Natchitoches Parish_LA",16462,14446,2016,0.122463856
22071,"Orleans Parish_LA",189977,170454,19523,0.102765072
22073,"Ouachita Parish_LA",70199,64578,5621,0.080072366
22075,"Plaquemines Parish_LA",10256,9777,479,0.046704368
22077,"Pointe Coupee Parish_LA",9924,9105,819,0.082527207
22079,"Rapides Parish_LA",57542,52620,4922,0.08553752
22081,"Red River Parish_LA",3569,3241,328,0.091902494
22083,"Richland Parish_LA",8894,8038,856,0.096244659
22085,"Sabine Parish_LA",9851,8803,1048,0.106385139
22087,"St. Bernard Parish_LA",19928,17494,2434,0.122139703
22089,"St. Charles Parish_LA",26863,24804,2059,0.076648178
22091,"St. Helena Parish_LA",4230,3619,611,0.144444444
22093,"St. James Parish_LA",10146,9035,1111,0.109501281
22095,"St. John the Baptist Parish_LA",21660,19661,1999,0.092289935
22097,"St. Landry Parish_LA",33190,31154,2036,0.061343778
22099,"St. Martin Parish_LA",25788,23921,1867,0.072398015
22101,"St. Mary Parish_LA",24096,21161,2935,0.121804449
22103,"St. Tammany Parish_LA",120015,110923,9092,0.075757197
22105,"Tangipahoa Parish_LA",60087,53685,6402,0.106545509
22107,"Tensas Parish_LA",1938,1636,302,0.155830753
22109,"Terrebonne Parish_LA",51291,48450,2841,0.055389834
22111,"Union Parish_LA",8773,8096,677,0.077168585
22113,"Vermilion Parish_LA",27334,25011,2323,0.084985732
22115,"Vernon Parish_LA",19135,17705,1430,0.074732166
22117,"WA Parish_LA",18038,15327,2711,0.150293824
22119,"Webster Parish_LA",16575,15313,1262,0.076138763
22121,"West Baton Rouge Parish_LA",12571,11757,814,0.064752207
22123,"West Carroll Parish_LA",4448,3917,531,0.119379496
22125,"West Feliciana Parish_LA",5490,5021,469,0.085428051
22127,"Winn Parish_LA",5251,4920,331,0.063035612
23001,"Androscoggin County_ME",57079,52961,4118,0.072145623
23003,"Aroostook County_ME",33104,30612,2492,0.075277912
23005,"Cumberland County_ME",160804,152196,8608,0.053531007
23007,"Franklin County_ME",15593,14386,1207,0.077406529
23009,"Hancock County_ME",28885,26665,2220,0.0768565
23011,"Kennebec County_ME",62593,57787,4806,0.076781749
23013,"Knox County_ME",20445,19270,1175,0.057471264
23015,"Lincoln County_ME",17207,16480,727,0.042250247
23017,"Oxford County_ME",27581,25041,2540,0.092092382
23019,"Penobscot County_ME",77936,71852,6084,0.078064053
23021,"Piscataquis County_ME",7411,6632,779,0.10511402
23023,"Sagadahoc County_ME",18766,17689,1077,0.057391026
23025,"Somerset County_ME",24602,22275,2327,0.094585806
23027,"Waldo County_ME",19866,18381,1485,0.074750831
23029,"WA County_ME",14362,12954,1408,0.098036485
23031,"York County_ME",109950,103506,6444,0.058608458
24001,"Allegany County_MD",33109,29810,3299,0.099640581
24003,"Anne Arundel County_MD",301868,284092,17776,0.058886666
24005,"Baltimore County_MD",442686,412199,30487,0.068868227
24009,"Calvert County_MD",48997,45249,3748,0.076494479
24011,"Caroline County_MD",16780,15306,1474,0.08784267
24013,"Carroll County_MD",92492,88196,4296,0.04644726
24015,"Cecil County_MD",52799,48849,3950,0.074812023
24017,"Charles County_MD",81735,76622,5113,0.062555821
24019,"Dorchester County_MD",17131,15354,1777,0.10373008
24021,"Frederick County_MD",134882,127105,7777,0.057657805
24023,"Garrett County_MD",14870,13830,1040,0.069939475
24025,"Harford County_MD",135991,127274,8717,0.06409983
24027,"Howard County_MD",171759,163278,8481,0.049377325
24029,"Kent County_MD",9679,8984,695,0.071804939
24031,"Montgomery County_MD",575171,540333,34838,0.060569813
24033,"Prince George's County_MD",509962,465639,44323,0.086914319
24035,"Queen Anne's County_MD",26730,25305,1425,0.053310887
24037,"St. Mary's County_MD",56659,53945,2714,0.047900598
24039,"Somerset County_MD",8829,8103,726,0.082229018
24041,"Talbot County_MD",18886,17620,1266,0.067033782
24043,"WA County_MD",73819,67555,6264,0.084856202
24045,"Wicomico County_MD",52545,47947,4598,0.087505947
24047,"Worcester County_MD",25496,22979,2517,0.098721368
24510,"Baltimore city_MD",311656,270930,40726,0.13067613
25001,"Barnstable County_MA",110754,102995,7759,0.07005616
25003,"Berkshire County_MA",68746,62596,6150,0.08945975
25005,"Bristol County_MA",295912,269391,26521,0.089624618
25007,"Dukes County_MA",9334,8849,485,0.051960574
25009,"Essex County_MA",415828,383882,31946,0.076825033
25011,"Franklin County_MA",39898,37218,2680,0.067171287
25013,"Hampden County_MA",236325,212742,23583,0.099790543
25015,"Hampshire County_MA",90874,84303,6571,0.072308911
25017,"Middlesex County_MA",886585,832753,53832,0.060718374
25019,"Nantucket County_MA",6349,6157,192,0.030240983
25021,"Norfolk County_MA",384882,358283,26599,0.069109493
25023,"Plymouth County_MA",273559,252016,21543,0.078750836
25025,"Suffolk County_MA",439457,401271,38186,0.086893598
25027,"Worcester County_MA",437636,403519,34117,0.077957481
26001,"Alcona County_MI",3745,3288,457,0.122029372
26003,"Alger County_MI",3549,3166,383,0.107917723
26005,"Allegan County_MI",54404,51081,3323,0.061080068
26007,"Alpena County_MI",13490,12233,1257,0.093180133
26009,"Antrim County_MI",10549,9528,1021,0.096786425
26011,"Arenac County_MI",6326,5569,757,0.119664875
26013,"Baraga County_MI",2565,2358,207,0.080701754
26015,"Barry County_MI",29210,26899,2311,0.079116741
26017,"Bay County_MI",50823,45913,4910,0.096609803
26019,"Benzie County_MI",8277,7579,698,0.084330071
26021,"Berrien County_MI",75525,68463,7062,0.093505462
26023,"Branch County_MI",19711,18328,1383,0.070163868
26025,"Calhoun County_MI",63007,56687,6320,0.100306315
26027,"Cass County_MI",24991,22556,2435,0.097435077
26029,"Charlevoix County_MI",12796,11793,1003,0.07838387
26031,"Cheboygan County_MI",11642,10029,1613,0.138550077
26033,"Chippewa County_MI",16683,14733,1950,0.116885452
26035,"Clare County_MI",12332,10708,1624,0.131689912
26037,"Clinton County_MI",38703,36177,2526,0.065266258
26039,"Crawford County_MI",5907,5197,710,0.120196377
26041,"Delta County_MI",17077,15510,1567,0.091760848
26043,"Dickinson County_MI",12005,11161,844,0.07030404
26045,"Eaton County_MI",55806,51451,4355,0.078038204
26047,"Emmet County_MI",17329,15869,1460,0.084251832
26049,"Genesee County_MI",186341,161750,24591,0.131967737
26051,"Gladwin County_MI",9811,8730,1081,0.110182448
26053,"Gogebic County_MI",6361,5759,602,0.094639208
26055,"Grand Traverse County_MI",46895,43804,3091,0.06591321
26057,"Gratiot County_MI",17472,15980,1492,0.085393773
26059,"Hillsdale County_MI",21216,19316,1900,0.089555053
26061,"Houghton County_MI",16642,15440,1202,0.072226896
26063,"Huron County_MI",15039,13869,1170,0.077797726
26065,"Ingham County_MI",146295,133091,13204,0.09025599
26067,"Ionia County_MI",29904,26785,3119,0.104300428
26069,"Iosco County_MI",9988,8780,1208,0.120945134
26071,"Iron County_MI",4750,4324,426,0.089684211
26073,"Isabella County_MI",37652,33411,4241,0.112636779
26075,"Jackson County_MI",72646,65183,7463,0.102731052
26077,"Kalamazoo County_MI",135142,122809,12333,0.091259564
26079,"Kalkaska County_MI",7603,6815,788,0.103643299
26081,"Kent County_MI",330899,305508,25391,0.076733384
26083,"Keweenaw County_MI",905,842,63,0.06961326
26085,"Lake County_MI",3798,3297,501,0.131911532
26087,"Lapeer County_MI",42085,37682,4403,0.104621599
26089,"Leelanau County_MI",10364,9628,736,0.071015052
26091,"Lenawee County_MI",47156,43095,4061,0.086118415
26093,"Livingston County_MI",97797,92068,5729,0.058580529
26095,"Luce County_MI",2380,2103,277,0.116386555
26097,"Mackinac County_MI",5109,4470,639,0.1250734
26099,"Macomb County_MI",440623,401146,39477,0.089593598
26101,"Manistee County_MI",10186,9010,1176,0.115452582
26103,"Marquette County_MI",32128,29522,2606,0.081113048
26105,"Mason County_MI",13645,12183,1462,0.107145475
26107,"Mecosta County_MI",20083,17639,2444,0.121694966
26109,"Menominee County_MI",11313,10346,967,0.085476885
26111,"Midland County_MI",40897,37406,3491,0.085360784
26113,"Missaukee County_MI",6849,6096,753,0.109943057
26115,"Monroe County_MI",74160,68024,6136,0.082740022
26117,"Montcalm County_MI",27677,24588,3089,0.111608917
26119,"Montmorency County_MI",3495,2937,558,0.159656652
26121,"Muskegon County_MI",79119,69673,9446,0.11938978
26123,"Newaygo County_MI",20710,18619,2091,0.100965717
26125,"Oakland County_MI",655894,606484,49410,0.075332295
26127,"Oceana County_MI",11348,10360,988,0.0870638
26129,"Ogemaw County_MI",8745,7661,1084,0.123956547
26131,"Ontonagon County_MI",2372,2048,324,0.136593592
26133,"Osceola County_MI",9817,8807,1010,0.102882754
26135,"Oscoda County_MI",3216,2792,424,0.131840796
26137,"Otsego County_MI",11688,10733,955,0.081707734
26139,"Ottawa County_MI",144359,135496,8863,0.061395549
26141,"Presque Isle County_MI",5164,4490,674,0.130518978
26143,"Roscommon County_MI",8812,7563,1249,0.141738538
26145,"Saginaw County_MI",91270,81106,10164,0.111361893
26147,"St. Clair County_MI",78027,69940,8087,0.103643611
26149,"St. Joseph County_MI",28810,26332,2478,0.086011801
26151,"Sanilac County_MI",19198,17147,2051,0.106834045
26153,"Schoolcraft County_MI",3321,2803,518,0.155977115
26155,"Shiawassee County_MI",33120,29702,3418,0.103200483
26157,"Tuscola County_MI",25442,23074,2368,0.093074444
26159,"Van Buren County_MI",35227,32252,2975,0.084452267
26161,"Washtenaw County_MI",190384,176383,14001,0.073540844
26163,"Wayne County_MI",818618,696900,121718,0.148687178
26165,"Wexford County_MI",14845,13441,1404,0.094577299
27001,"Aitkin County_MN",6932,6428,504,0.07270629
27003,"Anoka County_MN",193205,181190,12015,0.062187832
27005,"Becker County_MN",16509,15929,580,0.035132352
27007,"Beltrami County_MN",23007,20579,2428,0.105533099
27009,"Benton County_MN",21556,20104,1452,0.067359436
27011,"Big Stone County_MN",2488,2406,82,0.032958199
27013,"Blue Earth County_MN",38384,36492,1892,0.049291371
27015,"Brown County_MN",14038,13583,455,0.032412025
27017,"Carlton County_MN",17415,16478,937,0.053804192
27019,"Carver County_MN",54632,52573,2059,0.037688534
27021,"Cass County_MN",13141,12165,976,0.074271364
27023,"Chippewa County_MN",6536,6367,169,0.025856793
27025,"Chisago County_MN",29148,27553,1595,0.054720736
27027,"Clay County_MN",34588,33104,1484,0.042905054
27029,"Clearwater County_MN",3923,3634,289,0.073668111
27031,"Cook County_MN",2903,2788,115,0.039614192
27033,"Cottonwood County_MN",5686,5408,278,0.048892015
27035,"Crow Wing County_MN",31048,29263,1785,0.057491626
27037,"Dakota County_MN",235728,223989,11739,0.049798921
27039,"Dodge County_MN",11280,10890,390,0.034574468
27041,"Douglas County_MN",19866,18975,891,0.044850498
27043,"Faribault County_MN",7431,7117,314,0.042255416
27045,"Fillmore County_MN",11076,10595,481,0.04342723
27047,"Freeborn County_MN",16109,15322,787,0.048854678
27049,"Goodhue County_MN",24983,23662,1321,0.052875956
27051,"Grant County_MN",3054,2943,111,0.036345776
27053,"Hennepin County_MN",691752,650324,41428,0.059888515
27055,"Houston County_MN",10301,9795,506,0.049121445
27057,"Hubbard County_MN",9971,9475,496,0.049744258
27059,"Isanti County_MN",21032,19504,1528,0.072651198
27061,"Itasca County_MN",21486,19970,1516,0.070557572
27063,"Jackson County_MN",5569,5392,177,0.031783085
27065,"Kanabec County_MN",8078,7287,791,0.097920277
27067,"Kandiyohi County_MN",22866,21757,1109,0.048499956
27069,"Kittson County_MN",2245,2182,63,0.028062361
27071,"Koochiching County_MN",6377,5877,500,0.078406774
27073,"Lac qui Parle County_MN",3641,3506,135,0.037077726
27075,"Lake County_MN",5113,4870,243,0.047525914
27077,"Lake of the Woods County_MN",2075,1975,100,0.048192771
27079,"Le Sueur County_MN",15260,14456,804,0.052686763
27081,"Lincoln County_MN",3059,2974,85,0.027786858
27083,"Lyon County_MN",14561,13788,773,0.053087013
27085,"McLeod County_MN",19842,18957,885,0.044602359
27087,"Mahnomen County_MN",2446,2222,224,0.091578087
27089,"Marshall County_MN",4957,4726,231,0.046600767
27091,"Martin County_MN",10649,10273,376,0.03530848
27093,"Meeker County_MN",12046,11477,569,0.047235597
27095,"Mille Lacs County_MN",12726,11752,974,0.076536225
27097,"Morrison County_MN",17552,16533,1019,0.058056062
27099,"Mower County_MN",20508,19166,1342,0.065437878
27101,"Murray County_MN",4443,4244,199,0.044789557
27103,"Nicollet County_MN",19456,18672,784,0.040296053
27105,"Nobles County_MN",11209,10431,778,0.069408511
27107,"Norman County_MN",3272,3105,167,0.05103912
27109,"Olmsted County_MN",83597,80162,3435,0.041089991
27111,"Otter Tail County_MN",28934,27662,1272,0.043962121
27113,"Pennington County_MN",7873,7636,237,0.030102883
27115,"Pine County_MN",13658,12645,1013,0.074168985
27117,"Pipestone County_MN",4773,4572,201,0.042111879
27119,"Polk County_MN",16746,15978,768,0.045861698
27121,"Pope County_MN",5638,5406,232,0.041149344
27123,"Ramsey County_MN",287140,266709,20431,0.071153444
27125,"Red Lake County_MN",2155,2079,76,0.035266821
27127,"Redwood County_MN",7891,7577,314,0.039792168
27129,"Renville County_MN",7972,7573,399,0.050050176
27131,"Rice County_MN",35481,33503,1978,0.055748147
27133,"Rock County_MN",4895,4716,179,0.036567926
27135,"Roseau County_MN",8679,8447,232,0.02673119
27137,"St. Louis County_MN",103866,96700,7166,0.068992741
27139,"Scott County_MN",78109,74498,3611,0.046230268
27141,"Sherburne County_MN",50061,47444,2617,0.052276223
27143,"Sibley County_MN",8329,7867,462,0.055468844
27145,"Stearns County_MN",87959,83520,4439,0.050466695
27147,"Steele County_MN",19380,18434,946,0.048813209
27149,"Stevens County_MN",5221,5058,163,0.031220073
27151,"Swift County_MN",5063,4865,198,0.039107249
27153,"Todd County_MN",12051,11437,614,0.050950129
27155,"Traverse County_MN",1671,1623,48,0.028725314
27157,"Wabasha County_MN",11645,11221,424,0.036410477
27159,"Wadena County_MN",6180,5859,321,0.051941748
27161,"Waseca County_MN",10090,9630,460,0.045589693
27163,"WA County_MN",136663,130036,6627,0.048491545
27165,"Watonwan County_MN",5845,5676,169,0.028913601
27167,"Wilkin County_MN",3379,3312,67,0.019828352
27169,"Winona County_MN",30171,28307,1864,0.061781181
27171,"Wright County_MN",71357,67669,3688,0.051683787
27173,"Yellow Medicine County_MN",5329,5147,182,0.034152749
28001,"Adams County_MS",12096,10730,1366,0.112929894
28003,"Alcorn County_MS",16245,14784,1461,0.089935365
28005,"Amite County_MS",5226,4562,664,0.127057023
28007,"Attala County_MS",7599,6643,956,0.125806027
28009,"Benton County_MS",3611,2994,617,0.170866796
28011,"Bolivar County_MS",13971,11834,2137,0.152959702
28013,"Calhoun County_MS",6208,5580,628,0.101159794
28015,"Carroll County_MS",4204,3705,499,0.11869648
28017,"Chickasaw County_MS",7462,6554,908,0.121683195
28019,"Choctaw County_MS",3404,2921,483,0.141891892
28021,"Claiborne County_MS",2921,2411,510,0.17459774
28023,"Clarke County_MS",7204,6363,841,0.1167407
28025,"Clay County_MS",8976,7524,1452,0.161764706
28027,"Coahoma County_MS",10920,8706,2214,0.202747253
28029,"Copiah County_MS",12001,10280,1721,0.143404716
28031,"Covington County_MS",7677,6628,1049,0.136641917
28033,"DeSoto County_MS",89416,82634,6782,0.075847723
28035,"Forrest County_MS",37572,32647,4925,0.131081657
28037,"Franklin County_MS",3406,3102,304,0.089254257
28039,"George County_MS",9073,8260,813,0.089606525
28041,"Greene County_MS",4523,3955,568,0.125580367
28043,"Grenada County_MS",9018,8169,849,0.094145043
28045,"Hancock County_MS",20559,18482,2077,0.101026315
28047,"Harrison County_MS",91847,82911,8936,0.097292236
28049,"Hinds County_MS",117559,105504,12055,0.102544254
28051,"Holmes County_MS",6564,5301,1263,0.192413163
28053,"Humphreys County_MS",3660,2678,982,0.268306011
28055,"Issaquena County_MS",345,305,40,0.115942029
28057,"Itawamba County_MS",10395,9428,967,0.093025493
28059,"Jackson County_MS",64718,58824,5894,0.091072036
28061,"Jasper County_MS",6792,6257,535,0.07876914
28063,"Jefferson County_MS",2214,1861,353,0.159439928
28065,"Jefferson Davis County_MS",4703,4094,609,0.129491814
28067,"Jones County_MS",28558,26436,2122,0.074304923
28069,"Kemper County_MS",3936,3537,399,0.101371951
28071,"Lafayette County_MS",24664,22584,2080,0.084333441
28073,"Lamar County_MS",29465,26952,2513,0.085287629
28075,"Lauderdale County_MS",36233,32747,3486,0.096210637
28077,"Lawrence County_MS",5201,4638,563,0.108248414
28079,"Leake County_MS",9536,8537,999,0.104760906
28081,"Lee County_MS",40821,37654,3167,0.077582617
28083,"Leflore County_MS",11263,9422,1841,0.163455562
28085,"Lincoln County_MS",14247,13182,1065,0.074752579
28087,"Lowndes County_MS",27727,24232,3495,0.12605042
28089,"Madison County_MS",51341,48562,2779,0.05412828
28091,"Marion County_MS",10353,9272,1081,0.104414179
28093,"Marshall County_MS",15361,14066,1295,0.084304407
28095,"Monroe County_MS",15954,14217,1737,0.108875517
28097,"Montgomery County_MS",3944,3608,336,0.085192698
28099,"Neshoba County_MS",13597,12268,1329,0.097742149
28101,"Newton County_MS",9306,8319,987,0.106060606
28103,"Noxubee County_MS",4740,3841,899,0.189662447
28105,"Oktibbeha County_MS",22347,19381,2966,0.132724751
28107,"Panola County_MS",14293,12826,1467,0.102637655
28109,"Pearl River County_MS",23012,20219,2793,0.121371458
28111,"Perry County_MS",4741,4131,610,0.128664839
28113,"Pike County_MS",16005,14477,1528,0.095470166
28115,"Pontotoc County_MS",14424,13476,948,0.065723794
28117,"Prentiss County_MS",10649,9559,1090,0.102357029
28119,"Quitman County_MS",3110,2324,786,0.252733119
28121,"Rankin County_MS",73172,69233,3939,0.053832067
28123,"Scott County_MS",12500,10867,1633,0.13064
28125,"Sharkey County_MS",2155,1678,477,0.221345708
28127,"Simpson County_MS",11022,9821,1201,0.10896389
28129,"Smith County_MS",6758,6433,325,0.048091151
28131,"Stone County_MS",7664,6920,744,0.097077244
28133,"Sunflower County_MS",10492,8382,2110,0.201105604
28135,"Tallahatchie County_MS",4698,3806,892,0.189868029
28137,"Tate County_MS",12684,11418,1266,0.099810785
28139,"Tippah County_MS",9604,8428,1176,0.12244898
28141,"Tishomingo County_MS",8807,7885,922,0.104689452
28143,"Tunica County_MS",4785,4191,594,0.124137931
28145,"Union County_MS",12264,10949,1315,0.107224397
28147,"Walthall County_MS",6054,5382,672,0.111000991
28149,"Warren County_MS",21261,19554,1707,0.080287851
28151,"WA County_MS",21748,17034,4714,0.216755564
28153,"Wayne County_MS",8724,7906,818,0.093764328
28155,"Webster County_MS",3991,3544,447,0.112002005
28157,"Wilkinson County_MS",3228,2914,314,0.097273854
28159,"Winston County_MS",8021,7034,987,0.123051989
28161,"Yalobusha County_MS",5358,5055,303,0.056550952
28163,"Yazoo County_MS",10452,8382,2070,0.19804822
29001,"Adair County_MO",12048,11096,952,0.079017264
29003,"Andrew County_MO",9031,8583,448,0.04960691
29005,"Atchison County_MO",2812,2691,121,0.043029872
29007,"Audrain County_MO",11621,10600,1021,0.087858188
29009,"Barry County_MO",16098,14259,1839,0.114237794
29011,"Barton County_MO",5425,5075,350,0.064516129
29013,"Bates County_MO",7691,7186,505,0.065661162
29015,"Benton County_MO",7177,6442,735,0.102410478
29017,"Bollinger County_MO",5273,5064,209,0.039635881
29019,"Boone County_MO",95776,90949,4827,0.050398847
29021,"Buchanan County_MO",45441,42029,3412,0.075086376
29023,"Butler County_MO",19132,17340,1792,0.093665064
29025,"Caldwell County_MO",4103,3889,214,0.052156958
29027,"Callaway County_MO",20913,19844,1069,0.05111653
29029,"Camden County_MO",19145,17403,1742,0.090989815
29031,"Cape Girardeau County_MO",40211,37661,2550,0.063415483
29033,"Carroll County_MO",4404,4010,394,0.089464124
29035,"Carter County_MO",2660,2402,258,0.096992481
29037,"Cass County_MO",51582,48122,3460,0.067077663
29039,"Cedar County_MO",5616,5029,587,0.104522792
29041,"Chariton County_MO",3455,3323,132,0.038205499
29043,"Christian County_MO",40150,37578,2572,0.064059776
29045,"Clark County_MO",3363,3210,153,0.045495094
29047,"Clay County_MO",125824,118111,7713,0.061299911
29049,"Clinton County_MO",10242,9653,589,0.057508299
29051,"Cole County_MO",37828,35978,1850,0.048905573
29053,"Cooper County_MO",8394,7916,478,0.056945437
29055,"Crawford County_MO",10754,9393,1361,0.12655756
29057,"Dade County_MO",3590,3307,283,0.078830084
29059,"Dallas County_MO",6843,5943,900,0.131521263
29061,"Daviess County_MO",3628,3420,208,0.057331863
29063,"DeKalb County_MO",4599,4285,314,0.068275712
29065,"Dent County_MO",6481,5882,599,0.092424009
29067,"Douglas County_MO",5383,4897,486,0.090284228
29069,"Dunklin County_MO",12672,11646,1026,0.080965909
29071,"Franklin County_MO",52077,48336,3741,0.071835935
29073,"Gasconade County_MO",6991,6567,424,0.060649406
29075,"Gentry County_MO",3189,2989,200,0.062715585
29077,"Greene County_MO",145206,135307,9899,0.068172114
29079,"Grundy County_MO",4472,4272,200,0.044722719
29081,"Harrison County_MO",3988,3755,233,0.058425276
29083,"Henry County_MO",10105,9359,746,0.073824839
29085,"Hickory County_MO",3455,3020,435,0.125904486
29087,"Holt County_MO",2361,2238,123,0.052096569
29089,"Howard County_MO",4836,4533,303,0.062655087
29091,"Howell County_MO",17671,16205,1466,0.082960783
29093,"Iron County_MO",4377,3878,499,0.114005026
29095,"Jackson County_MO",353010,326275,26735,0.075734398
29097,"Jasper County_MO",58930,55374,3556,0.06034278
29099,"Jefferson County_MO",116680,106972,9708,0.08320192
29101,"Johnson County_MO",25968,23900,2068,0.079636476
29103,"Knox County_MO",1845,1709,136,0.073712737
29105,"Laclede County_MO",16131,14708,1423,0.088215238
29107,"Lafayette County_MO",16128,15021,1107,0.068638393
29109,"Lawrence County_MO",16993,15804,1189,0.069969988
29111,"Lewis County_MO",5210,4918,292,0.056046065
29113,"Lincoln County_MO",26348,23857,2491,0.09454228
29115,"Linn County_MO",5368,5125,243,0.045268256
29117,"Livingston County_MO",7000,6641,359,0.051285714
29119,"McDonald County_MO",10450,9544,906,0.086698565
29121,"Macon County_MO",7165,6541,624,0.087090021
29123,"Madison County_MO",5405,4854,551,0.101942646
29125,"Maries County_MO",3944,3551,393,0.09964503
29127,"Marion County_MO",13841,12851,990,0.071526624
29129,"Mercer County_MO",1737,1657,80,0.046056419
29131,"Miller County_MO",11788,10832,956,0.081099423
29133,"MS County_MO",5631,4945,686,0.121825608
29135,"Moniteau County_MO",7197,6712,485,0.06738919
29137,"Monroe County_MO",4086,3845,241,0.058981889
29139,"Montgomery County_MO",5658,5126,532,0.094026158
29141,"Morgan County_MO",7782,6875,907,0.116551015
29143,"New Madrid County_MO",8004,7298,706,0.088205897
29145,"Newton County_MO",27831,26122,1709,0.061406345
29147,"Nodaway County_MO",12083,11209,874,0.07233303
29149,"OR County_MO",4397,4083,314,0.071412327
29151,"Osage County_MO",6957,6752,205,0.029466724
29153,"Ozark County_MO",3560,3112,448,0.125842697
29155,"Pemiscot County_MO",7235,6423,812,0.112232205
29157,"Perry County_MO",9703,9292,411,0.042358034
29159,"Pettis County_MO",20032,18740,1292,0.064496805
29161,"Phelps County_MO",20914,19451,1463,0.069953141
29163,"Pike County_MO",7805,7300,505,0.064702114
29165,"Platte County_MO",52371,49463,2908,0.055526914
29167,"Polk County_MO",14348,12978,1370,0.095483691
29169,"Pulaski County_MO",17501,15279,2222,0.126964173
29171,"Putnam County_MO",2157,2097,60,0.027816412
29173,"Ralls County_MO",5137,4821,316,0.061514503
29175,"Randolph County_MO",10452,9519,933,0.089265212
29177,"Ray County_MO",11053,10147,906,0.081968696
29179,"Reynolds County_MO",2703,2404,299,0.110617832
29181,"Ripley County_MO",6099,5480,619,0.101492048
29183,"St. Charles County_MO",209599,198960,10639,0.05075883
29185,"St. Clair County_MO",3758,3408,350,0.093134646
29186,"Ste. Genevieve County_MO",8789,8313,476,0.054158607
29187,"St. Francois County_MO",27691,25384,2307,0.083312268
29189,"St. Louis County_MO",531591,492220,39371,0.074062578
29195,"Saline County_MO",11262,10642,620,0.055052389
29197,"Schuyler County_MO",2042,1891,151,0.073947111
29199,"Scotland County_MO",2284,2193,91,0.039842382
29201,"Scott County_MO",18533,17280,1253,0.06760913
29203,"Shannon County_MO",3700,3361,339,0.091621622
29205,"Shelby County_MO",3065,2888,177,0.057748777
29207,"Stoddard County_MO",13575,12334,1241,0.091418048
29209,"Stone County_MO",13463,12009,1454,0.107999703
29211,"Sullivan County_MO",2973,2794,179,0.060208544
29213,"Taney County_MO",25742,23414,2328,0.090435864
29215,"TX County_MO",9944,9142,802,0.080651649
29217,"Vernon County_MO",9989,9449,540,0.054059465
29219,"Warren County_MO",16317,14863,1454,0.089109518
29221,"WA County_MO",10387,9124,1263,0.121594301
29223,"Wayne County_MO",5205,4712,493,0.094716619
29225,"Webster County_MO",15570,14583,987,0.063391137
29227,"Worth County_MO",1017,973,44,0.043264503
29229,"Wright County_MO",7270,6583,687,0.094497937
29510,"St. Louis city_MO",168028,147194,20834,0.12399124
30001,"Beaverhead County_MT",4938,4615,323,0.065411098
30003,"Big Horn County_MT",5825,4663,1162,0.199484979
30005,"Blaine County_MT",2974,2574,400,0.134498991
30007,"Broadwater County_MT",2888,2759,129,0.04466759
30009,"Carbon County_MT",5335,5126,209,0.039175258
30011,"Carter County_MT",620,606,14,0.022580645
30013,"Cascade County_MT",39074,37069,2005,0.051312893
30015,"Chouteau County_MT",2622,2510,112,0.042715484
30017,"Custer County_MT",6439,6196,243,0.037738779
30019,"Daniels County_MT",940,916,24,0.025531915
30021,"Dawson County_MT",4789,4694,95,0.019837127
30023,"Deer Lodge County_MT",3991,3834,157,0.039338512
30025,"Fallon County_MT",1688,1632,56,0.033175355
30027,"Fergus County_MT",5756,5579,177,0.030750521
30029,"Flathead County_MT",47201,43907,3294,0.069786657
30031,"Gallatin County_MT",55947,52450,3497,0.062505586
30033,"Garfield County_MT",556,555,1,0.001798561
30035,"Glacier County_MT",5273,4515,758,0.143751185
30037,"Golden Valley County_MT",370,357,13,0.035135135
30039,"Granite County_MT",1363,1265,98,0.07190022
30041,"Hill County_MT",7667,7364,303,0.039520021
30043,"Jefferson County_MT",5669,5295,374,0.065972835
30045,"Judith Basin County_MT",981,943,38,0.038735984
30047,"Lake County_MT",13100,11798,1302,0.099389313
30049,"Lewis and Clark County_MT",34831,33126,1705,0.048950647
30051,"Liberty County_MT",995,950,45,0.045226131
30053,"Lincoln County_MT",7877,6844,1033,0.131141297
30055,"McCone County_MT",927,920,7,0.007551241
30057,"Madison County_MT",4077,3880,197,0.048319843
30059,"Meagher County_MT",927,891,36,0.038834951
30061,"Mineral County_MT",1732,1527,205,0.118360277
30063,"Missoula County_MT",64380,59103,5277,0.081966449
30065,"Musselshell County_MT",2062,1967,95,0.046071775
30067,"Park County_MT",8228,7782,446,0.054205153
30069,"Petroleum County_MT",272,254,18,0.066176471
30071,"Phillips County_MT",1886,1767,119,0.063096501
30073,"Pondera County_MT",2913,2738,175,0.060075524
30075,"Powder River County_MT",1010,965,45,0.044554455
30077,"Powell County_MT",2688,2629,59,0.021949405
30079,"Prairie County_MT",591,543,48,0.081218274
30081,"Ravalli County_MT",18694,17159,1535,0.082111908
30083,"Richland County_MT",6057,5904,153,0.02526003
30085,"Roosevelt County_MT",3834,3575,259,0.067553469
30087,"Rosebud County_MT",4478,4002,476,0.106297454
30089,"Sanders County_MT",4509,4091,418,0.092703482
30091,"Sheridan County_MT",1957,1904,53,0.027082269
30093,"Silver Bow County_MT",17747,16497,1250,0.07043444
30095,"Stillwater County_MT",4656,4487,169,0.036297251
30097,"Sweet Grass County_MT",1628,1613,15,0.009213759
30099,"Teton County_MT",2866,2720,146,0.05094208
30101,"Toole County_MT",2381,2308,73,0.030659387
30103,"Treasure County_MT",382,379,3,0.007853403
30105,"Valley County_MT",3853,3753,100,0.025953802
30107,"Wheatland County_MT",949,917,32,0.033719705
30109,"Wibaux County_MT",471,457,14,0.029723992
30111,"Yellowstone County_MT",81943,78572,3371,0.041138352
31001,"Adams County_NE",16693,15783,910,0.054513868
31003,"Antelope County_NE",3341,3288,53,0.015863514
31005,"Arthur County_NE",201,193,8,0.039800995
31007,"Banner County_NE",481,455,26,0.054054054
31009,"Blaine County_NE",289,287,2,0.006920415
31011,"Boone County_NE",2811,2777,34,0.01209534
31013,"Box Butte County_NE",5834,5606,228,0.039081248
31015,"Boyd County_NE",975,964,11,0.011282051
31017,"Brown County_NE",1596,1585,11,0.006892231
31019,"Buffalo County_NE",28244,27263,981,0.034733041
31021,"Burt County_NE",3149,3046,103,0.032708796
31023,"Butler County_NE",4488,4299,189,0.042112299
31025,"Cass County_NE",13624,13103,521,0.038241339
31027,"Cedar County_NE",4690,4588,102,0.021748401
31029,"Chase County_NE",2088,2073,15,0.007183908
31031,"Cherry County_NE",3359,3271,88,0.026198273
31033,"Cheyenne County_NE",5775,5681,94,0.016277056
31035,"Clay County_NE",3263,3171,92,0.028194913
31037,"Colfax County_NE",5583,5224,359,0.064302346
31039,"Cuming County_NE",4720,4562,158,0.033474576
31041,"Custer County_NE",5828,5694,134,0.02299245
31043,"Dakota County_NE",10827,10025,802,0.074074074
31045,"Dawes County_NE",4736,4613,123,0.025971284
31047,"Dawson County_NE",12935,12312,623,0.048163896
31049,"Deuel County_NE",1069,1023,46,0.04303087
31051,"Dixon County_NE",3055,2916,139,0.045499182
31053,"Dodge County_NE",19448,18447,1001,0.051470588
31055,"Douglas County_NE",293962,277349,16613,0.056514107
31057,"Dundy County_NE",971,932,39,0.040164779
31059,"Fillmore County_NE",3073,2969,104,0.03384315
31061,"Franklin County_NE",1632,1575,57,0.034926471
31063,"Frontier County_NE",1326,1294,32,0.02413273
31065,"Furnas County_NE",2404,2323,81,0.033693844
31067,"Gage County_NE",11575,11077,498,0.043023758
31069,"Garden County_NE",969,939,30,0.030959752
31071,"Garfield County_NE",1028,992,36,0.035019455
31073,"Gosper County_NE",1150,1091,59,0.051304348
31075,"Grant County_NE",433,418,15,0.034642032
31077,"Greeley County_NE",1149,1127,22,0.019147084
31079,"Hall County_NE",33166,31168,1998,0.060242417
31081,"Hamilton County_NE",4846,4723,123,0.025381758
31083,"Harlan County_NE",1716,1687,29,0.016899767
31085,"Hayes County_NE",559,549,10,0.017889088
31087,"Hitchcock County_NE",1400,1358,42,0.03
31089,"Holt County_NE",5580,5529,51,0.009139785
31091,"Hooker County_NE",341,331,10,0.029325513
31093,"Howard County_NE",3424,3287,137,0.040011682
31095,"Jefferson County_NE",3891,3734,157,0.040349525
31097,"Johnson County_NE",2129,2053,76,0.035697511
31099,"Kearney County_NE",3617,3478,139,0.038429638
31101,"Keith County_NE",4236,4116,120,0.028328612
31103,"Keya Paha County_NE",445,440,5,0.011235955
31105,"Kimball County_NE",1748,1658,90,0.051487414
31107,"Knox County_NE",4424,4277,147,0.033227848
31109,"Lancaster County_NE",169432,160866,8566,0.050557156
31111,"Lincoln County_NE",18126,17360,766,0.042259737
31113,"Logan County_NE",453,449,4,0.008830022
31115,"Loup County_NE",299,297,2,0.006688963
31117,"McPherson County_NE",224,222,2,0.008928571
31119,"Madison County_NE",19328,18727,601,0.031094785
31121,"Merrick County_NE",4406,4177,229,0.05197458
31123,"Morrill County_NE",2554,2451,103,0.040328896
31125,"Nance County_NE",1843,1784,59,0.032013022
31127,"Nemaha County_NE",3783,3481,302,0.079830822
31129,"Nuckolls County_NE",2286,2219,67,0.029308836
31131,"Otoe County_NE",8618,8225,393,0.045602228
31133,"Pawnee County_NE",1326,1265,61,0.046003017
31135,"Perkins County_NE",1525,1499,26,0.01704918
31137,"Phelps County_NE",4721,4641,80,0.016945562
31139,"Pierce County_NE",3844,3663,181,0.047086368
31141,"Platte County_NE",18544,17701,843,0.045459448
31143,"Polk County_NE",2898,2843,55,0.018978606
31145,"Red Willow County_NE",5960,5714,246,0.041275168
31147,"Richardson County_NE",4142,4000,142,0.034282955
31149,"Rock County_NE",778,765,13,0.016709512
31151,"Saline County_NE",7380,7130,250,0.033875339
31153,"Sarpy County_NE",91702,87645,4057,0.044241129
31155,"Saunders County_NE",11004,10624,380,0.034532897
31157,"Scotts Bluff County_NE",19012,17970,1042,0.05480749
31159,"Seward County_NE",8855,8543,312,0.035234331
31161,"Sheridan County_NE",2601,2564,37,0.014225298
31163,"Sherman County_NE",1620,1569,51,0.031481481
31165,"Sioux County_NE",671,662,9,0.013412817
31167,"Stanton County_NE",3235,3151,84,0.025965997
31169,"Thayer County_NE",2586,2542,44,0.017014695
31171,"Thomas County_NE",385,385,0,0
31173,"Thurston County_NE",2901,2483,418,0.144088245
31175,"Valley County_NE",2301,2268,33,0.014341591
31177,"WA County_NE",11009,10850,159,0.014442729
31179,"Wayne County_NE",5382,5219,163,0.030286139
31181,"Webster County_NE",1773,1689,84,0.047377327
31183,"Wheeler County_NE",509,494,15,0.029469548
31185,"York County_NE",7424,7274,150,0.020204741
32001,"Churchill County_NV",10530,9274,1256,0.119278253
32003,"Clark County_NV",1035802,923588,112214,0.108335377
32005,"Douglas County_NV",22264,20371,1893,0.085025153
32007,"Elko County_NV",27383,25865,1518,0.055435854
32009,"Esmeralda County_NV",496,437,59,0.118951613
32011,"Eureka County_NV",895,853,42,0.046927374
32013,"Humboldt County_NV",8996,8295,701,0.077923522
32015,"Lander County_NV",3003,2644,359,0.11954712
32017,"Lincoln County_NV",1944,1714,230,0.118312757
32019,"Lyon County_NV",23101,19958,3143,0.136054716
32021,"Mineral County_NV",2195,1856,339,0.154441913
32023,"Nye County_NV",16339,14143,2196,0.13440235
32027,"Pershing County_NV",2322,2101,221,0.095176572
32029,"Storey County_NV",1982,1777,205,0.103430878
32031,"Washoe County_NV",227973,207304,20669,0.090664245
32033,"White Pine County_NV",3948,3529,419,0.106129686
32510,"Carson City_NV",26606,23603,3003,0.112869278
33001,"Belknap County_NH",32082,30396,1686,0.052552833
33003,"Carroll County_NH",24413,22992,1421,0.058206693
33005,"Cheshire County_NH",42287,39695,2592,0.061295434
33007,"Coos County_NH",15729,14644,1085,0.068980863
33009,"Grafton County_NH",47583,45198,2385,0.050122943
33011,"Hillsborough County_NH",228742,215215,13527,0.059136494
33013,"Merrimack County_NH",80504,76330,4174,0.051848355
33015,"Rockingham County_NH",176304,166354,9950,0.056436609
33017,"Strafford County_NH",70950,66369,4581,0.064566596
33019,"Sullivan County_NH",22949,21617,1332,0.058041745
34001,"Atlantic County_NJ",146420,128151,18269,0.124771206
34003,"Bergen County_NJ",491436,459612,31824,0.064757161
34005,"Burlington County_NJ",242401,221766,20635,0.085127537
34007,"Camden County_NJ",269225,241708,27517,0.10220819
34009,"Cape May County_NJ",47650,42881,4769,0.100083945
34011,"Cumberland County_NJ",71148,63220,7928,0.111429696
34013,"Essex County_NJ",411643,358229,53414,0.129758067
34015,"Gloucester County_NJ",156035,141635,14400,0.092286987
34017,"Hudson County_NJ",374293,339606,34687,0.092673387
34019,"Hunterdon County_NJ",70077,65918,4159,0.059349002
34021,"Mercer County_NJ",196115,177609,18506,0.094363001
34023,"Middlesex County_NJ",435528,402766,32762,0.075223637
34025,"Monmouth County_NJ",333439,307183,26256,0.078743038
34027,"Morris County_NJ",276181,258862,17319,0.062708876
34029,"Ocean County_NJ",270474,246680,23794,0.087971487
34031,"Passaic County_NJ",251460,229762,21698,0.086288078
34033,"Salem County_NJ",32707,29226,3481,0.106429816
34035,"Somerset County_NJ",181012,170172,10840,0.059885532
34037,"Sussex County_NJ",82471,75669,6802,0.082477477
34039,"Union County_NJ",296786,267803,28983,0.097656224
34041,"Warren County_NJ",58602,53302,5300,0.090440599
35001,"Bernalillo County_NM",335809,307756,28053,0.083538559
35003,"Catron County_NM",1100,1049,51,0.046363636
35005,"Chaves County_NM",28633,26448,2185,0.076310551
35006,"Cibola County_NM",11361,9625,1736,0.15280345
35007,"Colfax County_NM",5504,4981,523,0.095021802
35009,"Curry County_NM",22673,20599,2074,0.091474441
35011,"De Baca County_NM",653,619,34,0.052067381
35013,"Do�a Ana County_NM",100530,88919,11611,0.115497861
35015,"Eddy County_NM",27205,25620,1585,0.058261349
35017,"Grant County_NM",11723,10585,1138,0.097074128
35019,"Guadalupe County_NM",1317,1301,16,0.012148823
35021,"Harding County_NM",218,205,13,0.059633028
35023,"Hidalgo County_NM",2127,1867,260,0.122237894
35025,"Lea County_NM",31182,29340,1842,0.059072542
35027,"Lincoln County_NM",8667,8030,637,0.073497173
35028,"Los Alamos County_NM",9243,8916,327,0.035378124
35029,"Luna County_NM",9726,8383,1343,0.138083488
35031,"McKinley County_NM",27065,22865,4200,0.155181969
35033,"Mora County_NM",1233,1166,67,0.054339011
35035,"Otero County_NM",25316,22092,3224,0.127350292
35037,"Quay County_NM",3093,2937,156,0.050436469
35039,"Rio Arriba County_NM",17245,15272,1973,0.114409974
35041,"Roosevelt County_NM",9005,8131,874,0.09705719
35043,"Sandoval County_NM",64331,58433,5898,0.091682082
35045,"San Juan County_NM",56816,51561,5255,0.092491552
35047,"San Miguel County_NM",10415,9751,664,0.063754201
35049,"Santa Fe County_NM",76458,70423,6035,0.078932224
35051,"Sierra County_NM",4261,3971,290,0.068059141
35053,"Socorro County_NM",6153,5706,447,0.072647489
35055,"Taos County_NM",16085,14356,1729,0.107491452
35057,"Torrance County_NM",6020,5348,672,0.111627907
35059,"Union County_NM",1728,1692,36,0.020833333
35061,"Valencia County_NM",32064,28088,3976,0.124001996
36001,"Albany County_NY",165753,155200,10553,0.063667023
36003,"Allegany County_NY",22467,20410,2057,0.091556505
36005,"Bronx County_NY",655467,563903,91564,0.139692769
36007,"Broome County_NY",96246,88758,7488,0.077800636
36009,"Cattaraugus County_NY",37339,34265,3074,0.08232679
36011,"Cayuga County_NY",39953,37023,2930,0.07333617
36013,"Chautauqua County_NY",62904,58012,4892,0.077769299
36015,"Chemung County_NY",40417,38219,2198,0.054383057
36017,"Chenango County_NY",23297,21652,1645,0.07060995
36019,"Clinton County_NY",38137,35522,2615,0.068568582
36021,"Columbia County_NY",32104,29962,2142,0.066720658
36023,"Cortland County_NY",25638,24080,1558,0.060769171
36025,"DE County_NY",21926,19850,2076,0.094682113
36027,"Dutchess County_NY",157487,143829,13658,0.086724619
36029,"Erie County_NY",474565,441369,33196,0.069950376
36031,"Essex County_NY",19290,17769,1521,0.078849145
36033,"Franklin County_NY",22039,20094,1945,0.088252643
36035,"Fulton County_NY",26598,24116,2482,0.093315287
36037,"Genesee County_NY",31807,29675,2132,0.06702927
36039,"Greene County_NY",21714,19731,1983,0.09132357
36041,"Hamilton County_NY",2090,1887,203,0.097129187
36043,"Herkimer County_NY",31847,29074,2773,0.087072566
36045,"Jefferson County_NY",50018,44732,5286,0.105681954
36047,"Kings County_NY",1297115,1167448,129667,0.099965693
36049,"Lewis County_NY",13046,11966,1080,0.082783995
36051,"Livingston County_NY",31825,30099,1726,0.054234093
36053,"Madison County_NY",34804,33023,1781,0.051172279
36055,"Monroe County_NY",392189,361948,30241,0.077108231
36057,"Montgomery County_NY",23800,21683,2117,0.08894958
36059,"Nassau County_NY",712003,666184,45819,0.064352257
36061,"NY County_NY",956034,884457,71577,0.074868676
36063,"Niagara County_NY",108956,100718,8238,0.075608503
36065,"Oneida County_NY",112269,103944,8325,0.074152259
36067,"Onondaga County_NY",238001,220774,17227,0.072382049
36069,"Ontario County_NY",57023,53394,3629,0.063640987
36071,"Orange County_NY",185121,171651,13470,0.07276322
36073,"Orleans County_NY",19004,17285,1719,0.090454641
36075,"Oswego County_NY",57804,52204,5600,0.096879109
36077,"Otsego County_NY",30635,28464,2171,0.070866656
36079,"Putnam County_NY",55162,51412,3750,0.067981582
36081,"Queens County_NY",1208386,1104930,103456,0.085615027
36083,"Rensselaer County_NY",86731,80144,6587,0.07594747
36085,"Richmond County_NY",224499,209113,15386,0.068534826
36087,"Rockland County_NY",158611,146049,12562,0.079200055
36089,"St. Lawrence County_NY",49685,44714,4971,0.100050317
36091,"Saratoga County_NY",121138,113884,7254,0.059882118
36093,"Schenectady County_NY",80078,74134,5944,0.074227628
36095,"Schoharie County_NY",15835,14179,1656,0.104578465
36097,"Schuyler County_NY",8678,8125,553,0.06372436
36099,"Seneca County_NY",16284,15385,899,0.055207566
36101,"Steuben County_NY",47077,43199,3878,0.082375682
36103,"Suffolk County_NY",785594,735010,50584,0.064389494
36105,"Sullivan County_NY",36453,32243,4210,0.11549118
36107,"Tioga County_NY",25727,23960,1767,0.068682707
36109,"Tompkins County_NY",52404,49291,3113,0.059403862
36111,"Ulster County_NY",94369,85617,8752,0.09274232
36113,"Warren County_NY",34120,31866,2254,0.066060961
36115,"WA County_NY",31746,28744,3002,0.094563095
36117,"Wayne County_NY",46592,43117,3475,0.07458362
36119,"Westchester County_NY",503509,465097,38412,0.076288607
36121,"WY County_NY",19967,18495,1472,0.073721641
36123,"Yates County_NY",12342,11496,846,0.068546427
37001,"Alamance County_NC",77233,71156,6077,0.078683982
37003,"Alexander County_NC",17784,16182,1602,0.090080972
37005,"Alleghany County_NC",4878,4365,513,0.105166052
37007,"Anson County_NC",11984,9875,2109,0.175984646
37009,"Ashe County_NC",12881,11790,1091,0.084698393
37011,"Avery County_NC",7384,6873,511,0.069203684
37013,"Beaufort County_NC",21224,18786,2438,0.114869959
37015,"Bertie County_NC",8275,7158,1117,0.134984894
37017,"Bladen County_NC",14841,13040,1801,0.121353009
37019,"Brunswick County_NC",51051,45213,5838,0.114356232
37021,"Buncombe County_NC",126022,117252,8770,0.069591024
37023,"Burke County_NC",41418,36632,4786,0.115553624
37025,"Cabarrus County_NC",96856,87960,8896,0.091847691
37027,"Caldwell County_NC",38543,33837,4706,0.122097398
37029,"Camden County_NC",4882,4429,453,0.09278984
37031,"Carteret County_NC",32848,29496,3352,0.102045787
37033,"Caswell County_NC",10413,9276,1137,0.109190435
37035,"Catawba County_NC",76187,69954,6233,0.081811858
37037,"Chatham County_NC",32563,29621,2942,0.090347941
37039,"Cherokee County_NC",10226,9362,864,0.084490514
37041,"Chowan County_NC",6541,5711,830,0.126891913
37043,"Clay County_NC",4471,3920,551,0.123238649
37045,"Cleveland County_NC",46408,40571,5837,0.125775728
37047,"Columbus County_NC",22796,20746,2050,0.089928058
37049,"Craven County_NC",45746,40530,5216,0.114020898
37051,"Cumberland County_NC",135847,118750,17097,0.125854822
37053,"Currituck County_NC",12761,11913,848,0.066452472
37055,"Dare County_NC",19858,18579,1279,0.064407292
37057,"Davidson County_NC",80447,71620,8827,0.109724415
37059,"Davie County_NC",19786,18364,1422,0.071868998
37061,"Duplin County_NC",27793,24654,3139,0.112942108
37063,"Durham County_NC",155747,145135,10612,0.068136144
37065,"Edgecombe County_NC",25357,21446,3911,0.154237489
37067,"Forsyth County_NC",179860,162790,17070,0.09490715
37069,"Franklin County_NC",29663,26738,2925,0.098607693
37071,"Gaston County_NC",103160,91563,11597,0.112417604
37073,"Gates County_NC",5541,4865,676,0.121999639
37075,"Graham County_NC",3314,2947,367,0.110742305
37077,"Granville County_NC",26357,24163,2194,0.083241644
37079,"Greene County_NC",9158,8070,1088,0.118803232
37081,"Guilford County_NC",258863,236140,22723,0.087780023
37083,"Halifax County_NC",22957,19726,3231,0.140741386
37085,"Harnett County_NC",52268,46375,5893,0.112745848
37087,"Haywood County_NC",26669,24728,1941,0.072781132
37089,"Henderson County_NC",49324,46387,2937,0.059545049
37091,"Hertford County_NC",10061,8679,1382,0.137362091
37093,"Hoke County_NC",19752,17168,2584,0.130822195
37095,"Hyde County_NC",2665,2326,339,0.127204503
37097,"Iredell County_NC",84388,76079,8309,0.098461867
37099,"Jackson County_NC",18734,17567,1167,0.062293157
37101,"Johnston County_NC",88532,80656,7876,0.088962183
37103,"Jones County_NC",4558,4029,529,0.116059675
37105,"Lee County_NC",28332,25418,2914,0.102851899
37107,"Lenoir County_NC",27579,23972,3607,0.130787918
37109,"Lincoln County_NC",40773,36605,4168,0.102224511
37111,"McDowell County_NC",19581,17404,2177,0.111179204
37113,"Macon County_NC",14399,13351,1048,0.072782832
37115,"Madison County_NC",9640,8935,705,0.07313278
37117,"Martin County_NC",10645,9079,1566,0.14711132
37119,"Mecklenburg County_NC",551638,502455,49183,0.089158107
37121,"Mitchell County_NC",6583,6014,569,0.086434756
37123,"Montgomery County_NC",11612,10397,1215,0.104633138
37125,"Moore County_NC",39586,36422,3164,0.079927247
37127,"Nash County_NC",46234,40735,5499,0.118938444
37129,"New Hanover County_NC",113887,103718,10169,0.089290261
37131,"Northampton County_NC",8553,7193,1360,0.159008535
37133,"Onslow County_NC",69270,61252,8018,0.115749964
37135,"Orange County_NC",75040,70264,4776,0.063646055
37137,"Pamlico County_NC",5657,5107,550,0.097224677
37139,"Pasquotank County_NC",18992,17073,1919,0.101042544
37141,"Pender County_NC",25769,23242,2527,0.098063565
37143,"Perquimans County_NC",5557,4852,705,0.126867015
37145,"Person County_NC",18856,16612,2244,0.119007213
37147,"Pitt County_NC",91498,80392,11106,0.121379702
37149,"Polk County_NC",9065,8270,795,0.087699945
37151,"Randolph County_NC",69443,63160,6283,0.090477082
37153,"Richmond County_NC",19555,16848,2707,0.138430069
37155,"Robeson County_NC",53908,47406,6502,0.120612896
37157,"Rockingham County_NC",42888,38380,4508,0.105110987
37159,"Rowan County_NC",63829,56519,7310,0.114524746
37161,"Rutherford County_NC",28525,25033,3492,0.122418931
37163,"Sampson County_NC",29958,26833,3125,0.104312704
37165,"Scotland County_NC",13265,11215,2050,0.154542028
37167,"Stanly County_NC",29727,26101,3626,0.121976654
37169,"Stokes County_NC",22031,19972,2059,0.093459217
37171,"Surry County_NC",32334,30107,2227,0.068874869
37173,"Swain County_NC",6006,5543,463,0.077089577
37175,"Transylvania County_NC",14821,13794,1027,0.06929357
37177,"Tyrrell County_NC",1571,1350,221,0.140674729
37179,"Union County_NC",108055,99712,8343,0.07721068
37181,"Vance County_NC",19895,17461,2434,0.122342297
37183,"Wake County_NC",533503,499197,34306,0.064303294
37185,"Warren County_NC",7790,6958,832,0.106803594
37187,"WA County_NC",5216,4410,806,0.15452454
37189,"Watauga County_NC",26430,23928,2502,0.094665153
37191,"Wayne County_NC",58014,50821,7193,0.123987313
37193,"Wilkes County_NC",30162,26631,3531,0.117067834
37195,"Wilson County_NC",38614,34701,3913,0.101336303
37197,"Yadkin County_NC",17175,15747,1428,0.083144105
37199,"Yancey County_NC",7857,6992,865,0.110092911
38001,"Adams County_ND",1295,1279,16,0.012355212
38003,"Barnes County_ND",6032,5889,143,0.023706897
38005,"Benson County_ND",2622,2461,161,0.061403509
38007,"Billings County_ND",572,564,8,0.013986014
38009,"Bottineau County_ND",3459,3369,90,0.026019081
38011,"Bowman County_ND",1752,1721,31,0.017694064
38013,"Burke County_ND",1110,1084,26,0.023423423
38015,"Burleigh County_ND",50562,49375,1187,0.023476128
38017,"Cass County_ND",97777,94675,3102,0.031725252
38019,"Cavalier County_ND",1984,1968,16,0.008064516
38021,"Dickey County_ND",2796,2755,41,0.014663805
38023,"Divide County_ND",1261,1252,9,0.007137193
38025,"Dunn County_ND",2171,2078,93,0.042837402
38027,"Eddy County_ND",1231,1208,23,0.018683997
38029,"Emmons County_ND",1642,1583,59,0.03593179
38031,"Foster County_ND",1810,1786,24,0.013259669
38033,"Golden Valley County_ND",974,964,10,0.01026694
38035,"Grand Forks County_ND",39160,37754,1406,0.035903984
38037,"Grant County_ND",1247,1205,42,0.033680834
38039,"Griggs County_ND",1227,1203,24,0.019559902
38041,"Hettinger County_ND",1225,1211,14,0.011428571
38043,"Kidder County_ND",1349,1337,12,0.008895478
38045,"LaMoure County_ND",2114,2073,41,0.019394513
38047,"Logan County_ND",973,952,21,0.021582734
38049,"McHenry County_ND",2932,2840,92,0.031377899
38051,"McIntosh County_ND",1364,1347,17,0.012463343
38053,"McKenzie County_ND",4912,4766,146,0.029723127
38055,"McLean County_ND",4615,4541,74,0.01603467
38057,"Mercer County_ND",4536,4391,145,0.03196649
38059,"Morton County_ND",16950,16411,539,0.03179941
38061,"Mountrail County_ND",4833,4607,226,0.046761846
38063,"Nelson County_ND",1565,1554,11,0.007028754
38065,"Oliver County_ND",889,857,32,0.035995501
38067,"Pembina County_ND",3829,3694,135,0.035257247
38069,"Pierce County_ND",2214,2194,20,0.009033424
38071,"Ramsey County_ND",5983,5910,73,0.012201237
38073,"Ransom County_ND",2905,2847,58,0.019965577
38075,"Renville County_ND",1322,1301,21,0.015885023
38077,"Richland County_ND",9073,8800,273,0.030089276
38079,"Rolette County_ND",5152,4907,245,0.047554348
38081,"Sargent County_ND",2104,2078,26,0.012357414
38083,"Sheridan County_ND",642,629,13,0.020249221
38085,"Sioux County_ND",1620,1291,329,0.20308642
38087,"Slope County_ND",335,335,0,0
38089,"Stark County_ND",16526,16062,464,0.02807697
38091,"Steele County_ND",1078,1035,43,0.039888683
38093,"Stutsman County_ND",11433,11144,289,0.025277705
38095,"Towner County_ND",1091,1059,32,0.029330889
38097,"Traill County_ND",4200,4085,115,0.027380952
38099,"Walsh County_ND",5645,5457,188,0.033303809
38101,"Ward County_ND",36528,35580,948,0.025952694
38103,"Wells County_ND",2083,2055,28,0.013442151
38105,"Williams County_ND",16476,16193,283,0.017176499
39001,"Adams County_OH",11699,10135,1564,0.13368664
39003,"Allen County_OH",52445,47604,4841,0.092306226
39005,"Ashland County_OH",26208,24172,2036,0.077686203
39007,"Ashtabula County_OH",44349,40422,3927,0.088547656
39009,"Athens County_OH",30055,26794,3261,0.108501081
39011,"Auglaize County_OH",23912,22719,1193,0.049891268
39013,"Belmont County_OH",32473,29728,2745,0.084531765
39015,"Brown County_OH",20750,18693,2057,0.09913253
39017,"Butler County_OH",190439,176782,13657,0.071713252
39019,"Carroll County_OH",13620,12657,963,0.070704846
39021,"Champaign County_OH",20044,18230,1814,0.090500898
39023,"Clark County_OH",65684,59111,6573,0.100070032
39025,"Clermont County_OH",102907,97207,5700,0.055389818
39027,"Clinton County_OH",20338,18460,1878,0.092339463
39029,"Columbiana County_OH",51208,46577,4631,0.090435088
39031,"Coshocton County_OH",16896,15576,1320,0.078125
39033,"Crawford County_OH",19747,18142,1605,0.081278169
39035,"Cuyahoga County_OH",645281,576603,68678,0.106431152
39037,"Darke County_OH",25697,23751,1946,0.075728684
39039,"Defiance County_OH",19741,18092,1649,0.083531736
39041,"DE County_OH",97560,94424,3136,0.032144321
39043,"Erie County_OH",38603,35636,2967,0.076859311
39045,"Fairfield County_OH",74905,69708,5197,0.069381216
39047,"Fayette County_OH",13546,12385,1161,0.085707958
39049,"Franklin County_OH",662811,616368,46443,0.070069748
39051,"Fulton County_OH",22364,20872,1492,0.066714362
39053,"Gallia County_OH",12262,11344,918,0.074865438
39055,"Geauga County_OH",48546,46540,2006,0.041321633
39057,"Greene County_OH",82357,76109,6248,0.075864832
39059,"Guernsey County_OH",18464,16310,2154,0.116659445
39061,"Hamilton County_OH",420681,383555,37126,0.088252144
39063,"Hancock County_OH",40362,37580,2782,0.068926218
39065,"Hardin County_OH",15293,13828,1465,0.095795462
39067,"Harrison County_OH",7141,6740,401,0.0561546
39069,"Henry County_OH",14405,13436,969,0.06726831
39071,"Highland County_OH",19174,16962,2212,0.115364556
39073,"Hocking County_OH",13481,12199,1282,0.095096803
39075,"Holmes County_OH",20051,19207,844,0.042092664
39077,"Huron County_OH",29072,26987,2085,0.071718492
39079,"Jackson County_OH",14907,13191,1716,0.115113705
39081,"Jefferson County_OH",30558,27871,2687,0.087931147
39083,"Knox County_OH",30163,28165,1998,0.066240095
39085,"Lake County_OH",124941,117389,7552,0.06044453
39087,"Lawrence County_OH",26607,24489,2118,0.079603112
39089,"Licking County_OH",87761,81446,6315,0.071956792
39091,"Logan County_OH",22491,20773,1718,0.07638611
39093,"Lorain County_OH",151906,138469,13437,0.088456019
39095,"Lucas County_OH",217589,193466,24123,0.110864979
39097,"Madison County_OH",19794,18617,1177,0.059462463
39099,"Mahoning County_OH",113967,103169,10798,0.094746725
39101,"Marion County_OH",28335,25608,2727,0.096241398
39103,"Medina County_OH",93556,88911,4645,0.049649408
39105,"Meigs County_OH",9973,8770,1203,0.120625689
39107,"Mercer County_OH",21675,20476,1199,0.055317186
39109,"Miami County_OH",53253,49186,4067,0.076371284
39111,"Monroe County_OH",6016,5571,445,0.073969415
39113,"Montgomery County_OH",261344,236657,24687,0.094461706
39115,"Morgan County_OH",6257,5678,579,0.092536359
39117,"Morrow County_OH",17315,16096,1219,0.070401386
39119,"Muskingum County_OH",40903,37501,3402,0.083172383
39121,"Noble County_OH",4988,4641,347,0.069566961
39123,"Ottawa County_OH",20680,19539,1141,0.055174081
39125,"Paulding County_OH",9253,8638,615,0.06646493
39127,"Perry County_OH",16172,14630,1542,0.095349988
39129,"Pickaway County_OH",26602,24777,1825,0.068603864
39131,"Pike County_OH",11419,9887,1532,0.134162361
39133,"Portage County_OH",89360,81544,7816,0.087466428
39135,"Preble County_OH",20830,19308,1522,0.073067691
39137,"Putnam County_OH",18193,17579,614,0.033749244
39139,"Richland County_OH",55470,50632,4838,0.087218316
39141,"Ross County_OH",33916,30096,3820,0.112631207
39143,"Sandusky County_OH",30484,28181,2303,0.075547828
39145,"Scioto County_OH",30524,27592,2932,0.096055563
39147,"Seneca County_OH",27569,25327,2242,0.081323225
39149,"Shelby County_OH",25337,23649,1688,0.066621936
39151,"Stark County_OH",191106,174941,16165,0.084586565
39153,"Summit County_OH",282196,258416,23780,0.084267672
39155,"Trumbull County_OH",95222,88133,7089,0.074447082
39157,"Tuscarawas County_OH",46094,42879,3215,0.069748774
39159,"Union County_OH",26456,25357,1099,0.041540671
39161,"Van Wert County_OH",14223,13163,1060,0.074527174
39163,"Vinton County_OH",5752,5060,692,0.120305981
39165,"Warren County_OH",112249,105433,6816,0.060722145
39167,"WA County_OH",27980,26082,1898,0.067834167
39169,"Wayne County_OH",57280,54503,2777,0.048481145
39171,"Williams County_OH",18429,17119,1310,0.071083618
39173,"Wood County_OH",70459,65406,5053,0.071715466
39175,"Wyandot County_OH",11799,11017,782,0.066276803
40001,"Adair County_OK",9049,8336,713,0.078793237
40003,"Alfalfa County_OK",2287,2176,111,0.048535199
40005,"Atoka County_OK",5144,4695,449,0.087286159
40007,"Beaver County_OK",2633,2555,78,0.029624003
40009,"Beckham County_OK",9894,9611,283,0.028603194
40011,"Blaine County_OK",3370,3270,100,0.029673591
40013,"Bryan County_OK",20101,18472,1629,0.081040744
40015,"Caddo County_OK",12379,11208,1171,0.094595686
40017,"Canadian County_OK",65993,63025,2968,0.044974467
40019,"Carter County_OK",22165,20820,1345,0.060681254
40021,"Cherokee County_OK",20963,19314,1649,0.078662405
40023,"Choctaw County_OK",5825,5308,517,0.088755365
40025,"Cimarron County_OK",1156,1131,25,0.021626298
40027,"Cleveland County_OK",140826,133949,6877,0.048833312
40029,"Coal County_OK",2526,2296,230,0.091053048
40031,"Comanche County_OK",54337,49641,4696,0.086423616
40033,"Cotton County_OK",2871,2607,264,0.091954023
40035,"Craig County_OK",6177,5781,396,0.064108791
40037,"Creek County_OK",31538,29749,1789,0.05672522
40039,"Custer County_OK",14608,14072,536,0.036692223
40041,"DE County_OK",17617,15991,1626,0.092297213
40043,"Dewey County_OK",2118,2061,57,0.026912181
40045,"Ellis County_OK",1921,1824,97,0.050494534
40047,"Garfield County_OK",29719,28056,1663,0.055957468
40049,"Garvin County_OK",11164,10668,496,0.04442852
40051,"Grady County_OK",25170,24086,1084,0.043067143
40053,"Grant County_OK",2177,2098,79,0.03628847
40055,"Greer County_OK",2452,2344,108,0.044045677
40057,"Harmon County_OK",1248,1139,109,0.087339744
40059,"Harper County_OK",1808,1779,29,0.016039823
40061,"Haskell County_OK",5022,4585,437,0.087017125
40063,"Hughes County_OK",4892,4546,346,0.070727719
40065,"Jackson County_OK",11241,10388,853,0.075882929
40067,"Jefferson County_OK",2672,2497,175,0.065494012
40069,"Johnston County_OK",4371,4078,293,0.067032716
40071,"Kay County_OK",21239,19588,1651,0.077734357
40073,"Kingfisher County_OK",7563,7289,274,0.03622901
40075,"KIA County_OK",4274,4037,237,0.055451568
40077,"Latimer County_OK",4411,4068,343,0.077760145
40079,"Le Flore County_OK",20211,18311,1900,0.094008213
40081,"Lincoln County_OK",15746,14625,1121,0.071192684
40083,"Logan County_OK",21587,20281,1306,0.060499375
40085,"Love County_OK",4298,4127,171,0.039785947
40087,"McClain County_OK",17426,16746,680,0.039022151
40089,"McCurtain County_OK",13460,12348,1112,0.082615156
40091,"McIntosh County_OK",7785,6944,841,0.108028259
40093,"Major County_OK",3718,3518,200,0.053792361
40095,"Marshall County_OK",6532,6038,494,0.075627679
40097,"Mayes County_OK",18111,16849,1262,0.069681409
40099,"Murray County_OK",6344,6115,229,0.0360971
40101,"Muskogee County_OK",29586,27158,2428,0.082065842
40103,"Noble County_OK",5463,5141,322,0.058941973
40105,"Nowata County_OK",4636,4248,388,0.083692839
40107,"Okfuskee County_OK",4359,3942,417,0.095664143
40109,"OK County_OK",375673,353043,22630,0.060238559
40111,"Okmulgee County_OK",16692,14956,1736,0.104001917
40113,"Osage County_OK",20742,19274,1468,0.070774274
40115,"Ottawa County_OK",14266,12922,1344,0.09421001
40117,"Pawnee County_OK",7356,6890,466,0.063349647
40119,"Payne County_OK",39243,36780,2463,0.062762786
40121,"Pittsburg County_OK",19676,18459,1217,0.061852002
40123,"Pontotoc County_OK",18613,17465,1148,0.061677322
40125,"Pottawatomie County_OK",31523,29366,2157,0.068426228
40127,"Pushmataha County_OK",4559,4074,485,0.106382979
40129,"Roger Mills County_OK",1712,1698,14,0.00817757
40131,"Rogers County_OK",44523,42093,2430,0.054578532
40133,"Seminole County_OK",10239,9379,860,0.083992577
40135,"Sequoyah County_OK",17235,15545,1690,0.098056281
40137,"Stephens County_OK",20365,19029,1336,0.06560275
40139,"TX County_OK",11544,11144,400,0.034650035
40141,"Tillman County_OK",3333,3098,235,0.070507051
40143,"Tulsa County_OK",323406,302471,20935,0.064732874
40145,"Wagoner County_OK",36751,34531,2220,0.06040652
40147,"WA County_OK",24307,23028,1279,0.052618587
40149,"Washita County_OK",5240,5057,183,0.034923664
40151,"Woods County_OK",4492,4365,127,0.028272484
40153,"Woodward County_OK",9846,9345,501,0.050883608
41001,"Baker County_OR",7091,6376,715,0.100832041
41003,"Benton County_OR",43662,39915,3747,0.085818332
41005,"Clackamas County_OR",202373,185660,16713,0.082585127
41007,"Clatsop County_OR",18221,16843,1378,0.075627024
41009,"Columbia County_OR",22584,20362,2222,0.098388239
41011,"Coos County_OR",26566,23458,3108,0.116991643
41013,"Crook County_OR",9270,8014,1256,0.135490831
41015,"Curry County_OR",8938,7930,1008,0.112776908
41017,"Deschutes County_OR",82370,74599,7771,0.0943426
41019,"Douglas County_OR",45039,39563,5476,0.121583517
41021,"Gilliam County_OR",862,783,79,0.091647332
41023,"Grant County_OR",3164,2878,286,0.090391909
41025,"Harney County_OR",3458,2901,557,0.161075766
41027,"Hood River County_OR",11861,11251,610,0.051429053
41029,"Jackson County_OR",98287,87699,10588,0.107725335
41031,"Jefferson County_OR",9546,8167,1379,0.144458412
41033,"Josephine County_OR",32521,28510,4011,0.123335691
41035,"Klamath County_OR",29396,25753,3643,0.123928426
41037,"Lake County_OR",3396,3037,359,0.105712603
41039,"Lane County_OR",175887,158490,17397,0.098910096
41041,"Lincoln County_OR",21123,19454,1669,0.079013398
41043,"Linn County_OR",54693,48892,5801,0.106064761
41045,"Malheur County_OR",11927,10595,1332,0.111679383
41047,"Marion County_OR",154202,137706,16496,0.106976563
41049,"Morrow County_OR",5284,4827,457,0.086487509
41051,"Multnomah County_OR",432574,394637,37937,0.087700602
41053,"Polk County_OR",36638,32687,3951,0.107838856
41055,"Sherman County_OR",810,746,64,0.079012346
41057,"Tillamook County_OR",10571,9747,824,0.077949106
41059,"Umatilla County_OR",35805,32450,3355,0.093701997
41061,"Union County_OR",11868,11024,844,0.071115605
41063,"Wallowa County_OR",3201,2898,303,0.094657919
41065,"Wasco County_OR",11987,10907,1080,0.090097606
41067,"WA County_OR",299165,276371,22794,0.076192068
41069,"Wheeler County_OR",615,563,52,0.084552846
41071,"Yamhill County_OR",48868,44114,4754,0.097282475
42001,"Adams County_PA",53557,50517,3040,0.056761955
42003,"Allegheny County_PA",658754,612259,46495,0.070580217
42005,"Armstrong County_PA",32668,29897,2771,0.084823068
42007,"Beaver County_PA",86691,80816,5875,0.067769434
42009,"Bedford County_PA",24262,22499,1763,0.072665073
42011,"Berks County_PA",217230,197703,19527,0.089890899
42013,"Blair County_PA",61182,57253,3929,0.064218234
42015,"Bradford County_PA",28266,26689,1577,0.05579141
42017,"Bucks County_PA",345609,321488,24121,0.069792743
42019,"Butler County_PA",97655,91888,5767,0.059054836
42021,"Cambria County_PA",63417,58018,5399,0.085134901
42023,"Cameron County_PA",2360,2254,106,0.044915254
42025,"Carbon County_PA",31706,28973,2733,0.086198196
42027,"Centre County_PA",79363,75314,4049,0.051018737
42029,"Chester County_PA",276983,260731,16252,0.058675081
42031,"Clarion County_PA",18560,17055,1505,0.081088362
42033,"Clearfield County_PA",37014,34110,2904,0.0784568
42035,"Clinton County_PA",19027,17861,1166,0.061281337
42037,"Columbia County_PA",31935,30123,1812,0.056740254
42039,"Crawford County_PA",40721,37783,2938,0.072149505
42041,"Cumberland County_PA",128433,121280,7153,0.055694409
42043,"Dauphin County_PA",142361,132283,10078,0.07079186
42045,"DE County_PA",293153,269220,23933,0.081639963
42047,"Elk County_PA",15771,14947,824,0.052247797
42049,"Erie County_PA",139709,128541,11168,0.079937585
42051,"Fayette County_PA",58620,53700,4920,0.083930399
42053,"Forest County_PA",1320,1256,64,0.048484848
42055,"Franklin County_PA",76529,71278,5251,0.068614512
42057,"Fulton County_PA",7134,6598,536,0.075133165
42059,"Greene County_PA",15738,14728,1010,0.06417588
42061,"Huntingdon County_PA",20207,18580,1627,0.080516653
42063,"IN County_PA",42186,38903,3283,0.077822026
42065,"Jefferson County_PA",21118,19756,1362,0.064494744
42067,"Juniata County_PA",11824,11152,672,0.056833559
42069,"Lackawanna County_PA",104845,97589,7256,0.069206925
42071,"Lancaster County_PA",276565,259601,16964,0.061338203
42073,"Lawrence County_PA",42308,39340,2968,0.070152217
42075,"Lebanon County_PA",69939,65090,4849,0.069331846
42077,"Lehigh County_PA",186205,170448,15757,0.084621788
42079,"Luzerne County_PA",159734,147243,12491,0.078198755
42081,"Lycoming County_PA",58837,54324,4513,0.076703435
42083,"McKean County_PA",20107,18277,1830,0.09101308
42085,"Mercer County_PA",53721,50055,3666,0.06824147
42087,"Mifflin County_PA",21215,19860,1355,0.063869903
42089,"Monroe County_PA",87210,76767,10443,0.119745442
42091,"Montgomery County_PA",447095,418411,28684,0.064156387
42093,"Montour County_PA",8983,8391,592,0.06590226
42095,"Northampton County_PA",156288,144854,11434,0.073159808
42097,"Northumberland County_PA",44236,41033,3203,0.072407089
42099,"Perry County_PA",24437,22893,1544,0.063182878
42101,"Philadelphia County_PA",744184,640661,103523,0.139109414
42103,"Pike County_PA",27500,24320,3180,0.115636364
42105,"Potter County_PA",7474,6956,518,0.069306931
42107,"Schuylkill County_PA",69332,63264,6068,0.087520914
42109,"Snyder County_PA",20426,19403,1023,0.050083227
42111,"Somerset County_PA",35617,33159,2458,0.069011989
42113,"Sullivan County_PA",2883,2632,251,0.087062088
42115,"Susquehanna County_PA",20642,19048,1594,0.077221199
42117,"Tioga County_PA",19756,18289,1467,0.074255922
42119,"Union County_PA",18731,17585,1146,0.061181998
42121,"Venango County_PA",25609,23527,2082,0.081299543
42123,"Warren County_PA",19856,18545,1311,0.066025383
42125,"WA County_PA",106612,99731,6881,0.064542453
42127,"Wayne County_PA",23008,21211,1797,0.078103268
42129,"Westmoreland County_PA",183920,173533,10387,0.056475642
42131,"WY County_PA",14075,13003,1072,0.07616341
42133,"York County_PA",234469,217393,17076,0.072828391
44001,"Bristol County_RI",26588,24777,1811,0.068113435
44003,"Kent County_RI",93946,86274,7672,0.081663935
44005,"Newport County_RI",44023,40977,3046,0.069191105
44007,"Providence County_RI",332774,301318,31456,0.094526616
44009,"WA County_RI",69257,64824,4433,0.06400797
45001,"Abbeville County_SC",10411,9294,1117,0.107290366
45003,"Aiken County_SC",77035,69420,7615,0.098851172
45005,"Allendale County_SC",3705,2866,839,0.226450742
45007,"Anderson County_SC",89435,81226,8209,0.091787332
45009,"Bamberg County_SC",6205,5527,678,0.10926672
45011,"Barnwell County_SC",9408,8026,1382,0.146896259
45013,"Beaufort County_SC",75963,70487,5476,0.072087727
45015,"Berkeley County_SC",93816,84494,9322,0.099364714
45017,"Calhoun County_SC",7064,6455,609,0.086211778
45019,"Charleston County_SC",198388,183111,15277,0.077005666
45021,"Cherokee County_SC",23462,20966,2496,0.106384792
45023,"Chester County_SC",14267,12296,1971,0.138150978
45025,"Chesterfield County_SC",19768,17730,2038,0.103095913
45027,"Clarendon County_SC",13660,11443,2217,0.162298682
45029,"Colleton County_SC",16935,14841,2094,0.123649247
45031,"Darlington County_SC",30857,25949,4908,0.159056292
45033,"Dillon County_SC",12441,10805,1636,0.131500683
45035,"Dorchester County_SC",72548,66723,5825,0.080291669
45037,"Edgefield County_SC",11088,10099,989,0.089195527
45039,"Fairfield County_SC",9965,8693,1272,0.127646764
45041,"Florence County_SC",66323,58296,8027,0.121028904
45043,"Georgetown County_SC",25619,22756,2863,0.111752996
45045,"Greenville County_SC",237964,219810,18154,0.07628885
45047,"Greenwood County_SC",32719,28506,4213,0.128763104
45049,"Hampton County_SC",8745,7787,958,0.109548313
45051,"Horry County_SC",141542,129161,12381,0.08747227
45053,"Jasper County_SC",13286,11707,1579,0.118846907
45055,"Kershaw County_SC",29442,26360,3082,0.104680389
45057,"Lancaster County_SC",36810,33151,3659,0.099402336
45059,"Laurens County_SC",30681,27397,3284,0.107036928
45061,"Lee County_SC",7221,6146,1075,0.148871347
45063,"Lexington County_SC",142835,132105,10730,0.075121644
45065,"McCormick County_SC",3465,2970,495,0.142857143
45067,"Marion County_SC",13798,11875,1923,0.139368024
45069,"Marlboro County_SC",11356,9600,1756,0.154631913
45071,"Newberry County_SC",17569,15784,1785,0.101599408
45073,"Oconee County_SC",32133,28796,3337,0.103849625
45075,"Orangeburg County_SC",38754,33811,4943,0.127548124
45077,"Pickens County_SC",55957,50816,5141,0.091874118
45079,"Richland County_SC",203598,184364,19234,0.094470476
45081,"Saluda County_SC",8909,8107,802,0.090021327
45083,"Spartanburg County_SC",140765,128253,12512,0.088885732
45085,"Sumter County_SC",47927,41972,5955,0.124251466
45087,"Union County_SC",12639,11086,1553,0.122873645
45089,"Williamsburg County_SC",12916,11416,1500,0.116135026
45091,"York County_SC",123857,112791,11066,0.08934497
46003,"Aurora County_SD",1378,1352,26,0.018867925
46005,"Beadle County_SD",9465,9189,276,0.029160063
46007,"Bennett County_SD",1369,1168,201,0.146822498
46009,"Bon Homme County_SD",2832,2806,26,0.009180791
46011,"Brookings County_SD",19623,19007,616,0.031391734
46013,"Brown County_SD",21286,20762,524,0.024617119
46015,"Brule County_SD",2652,2583,69,0.0260181
46017,"Buffalo County_SD",780,653,127,0.162820513
46019,"Butte County_SD",5169,5015,154,0.029792997
46021,"Campbell County_SD",766,755,11,0.014360313
46023,"Charles Mix County_SD",4105,3894,211,0.051400731
46025,"Clark County_SD",1879,1826,53,0.028206493
46027,"Clay County_SD",8054,7510,544,0.067544077
46029,"Codington County_SD",16034,15575,459,0.028626668
46031,"Corson County_SD",1757,1240,517,0.294251565
46033,"Custer County_SD",4032,3823,209,0.051835317
46035,"Davison County_SD",10707,10359,348,0.032502101
46037,"Day County_SD",2759,2652,107,0.038782167
46039,"Deuel County_SD",2390,2317,73,0.030543933
46041,"Dewey County_SD",2521,1900,621,0.246330821
46043,"Douglas County_SD",1544,1538,6,0.00388601
46045,"Edmunds County_SD",2109,2070,39,0.018492176
46047,"Fall River County_SD",3135,3005,130,0.041467305
46049,"Faulk County_SD",1170,1162,8,0.006837607
46051,"Grant County_SD",4124,3953,171,0.041464597
46053,"Gregory County_SD",2050,2007,43,0.02097561
46055,"Haakon County_SD",1044,1018,26,0.024904215
46057,"Hamlin County_SD",2949,2874,75,0.02543235
46059,"Hand County_SD",1798,1768,30,0.016685206
46061,"Hanson County_SD",1692,1673,19,0.011229314
46063,"Harding County_SD",694,684,10,0.014409222
46065,"Hughes County_SD",9927,9620,307,0.030925758
46067,"Hutchinson County_SD",3860,3745,115,0.029792746
46069,"Hyde County_SD",776,762,14,0.018041237
46071,"Jackson County_SD",1456,1202,254,0.174450549
46073,"Jerauld County_SD",1042,1033,9,0.008637236
46075,"Jones County_SD",500,482,18,0.036
46077,"Kingsbury County_SD",2685,2631,54,0.020111732
46079,"Lake County_SD",6769,6468,301,0.044467425
46081,"Lawrence County_SD",13519,13004,515,0.038094534
46083,"Lincoln County_SD",28152,27623,529,0.01879085
46085,"Lyman County_SD",1857,1719,138,0.074313409
46087,"McCook County_SD",3037,2974,63,0.020744155
46089,"McPherson County_SD",1090,1017,73,0.066972477
46091,"Marshall County_SD",2412,2394,18,0.007462687
46093,"Meade County_SD",13214,12907,307,0.023232935
46095,"Mellette County_SD",841,740,101,0.120095125
46097,"Miner County_SD",1224,1174,50,0.040849673
46099,"Minnehaha County_SD",103008,98459,4549,0.044161619
46101,"Moody County_SD",3598,3379,219,0.060867148
46102,"Oglala Lakota County_SD",4525,3226,1299,0.287071823
46103,"Pennington County_SD",56294,53612,2682,0.047642733
46105,"Perkins County_SD",1560,1490,70,0.044871795
46107,"Potter County_SD",1148,1142,6,0.005226481
46109,"Roberts County_SD",4777,4416,361,0.075570442
46111,"Sanborn County_SD",1335,1289,46,0.034456929
46115,"Spink County_SD",3302,3266,36,0.010902483
46117,"Stanley County_SD",1698,1674,24,0.014134276
46119,"Sully County_SD",802,788,14,0.017456359
46121,"Todd County_SD",3888,2901,987,0.253858025
46123,"Tripp County_SD",2923,2863,60,0.020526856
46125,"Turner County_SD",4357,4248,109,0.025017214
46127,"Union County_SD",7801,7576,225,0.028842456
46129,"Walworth County_SD",2755,2595,160,0.058076225
46135,"Yankton County_SD",11769,11348,421,0.035771943
46137,"Ziebach County_SD",1305,948,357,0.273563218
47001,"Anderson County_TN",34455,31814,2641,0.076650704
47003,"Bedford County_TN",21597,19939,1658,0.076769922
47005,"Benton County_TN",6819,5844,975,0.142982842
47007,"Bledsoe County_TN",5240,4739,501,0.095610687
47009,"Blount County_TN",61046,56262,4784,0.078367133
47011,"Bradley County_TN",49171,43685,5486,0.111569828
47013,"Campbell County_TN",15429,13897,1532,0.099293538
47015,"Cannon County_TN",6572,5724,848,0.129032258
47017,"Carroll County_TN",12087,10700,1387,0.114751386
47019,"Carter County_TN",25269,23210,2059,0.08148324
47021,"Cheatham County_TN",20146,18572,1574,0.078129654
47023,"Chester County_TN",8363,7235,1128,0.134879828
47025,"Claiborne County_TN",13007,11935,1072,0.08241716
47027,"Clay County_TN",2980,2765,215,0.072147651
47029,"Cocke County_TN",15823,14071,1752,0.110724894
47031,"Coffee County_TN",23955,21841,2114,0.0882488
47033,"Crockett County_TN",6229,5766,463,0.074329748
47035,"Cumberland County_TN",22280,20279,2001,0.08981149
47037,"Davidson County_TN",367958,341548,26410,0.071774496
47039,"Decatur County_TN",5083,4569,514,0.101121385
47041,"DeKalb County_TN",8017,7409,608,0.075838842
47043,"Dickson County_TN",23624,21847,1777,0.075220115
47045,"Dyer County_TN",17241,16095,1146,0.066469462
47047,"Fayette County_TN",18623,17031,1592,0.08548569
47049,"Fentress County_TN",6692,5998,694,0.103705918
47051,"Franklin County_TN",18806,17027,1779,0.094597469
47053,"Gibson County_TN",22315,20201,2114,0.094734484
47055,"Giles County_TN",13180,11881,1299,0.098558422
47057,"Grainger County_TN",9877,8940,937,0.094866862
47059,"Greene County_TN",30842,28160,2682,0.086959341
47061,"Grundy County_TN",5043,4529,514,0.101923458
47063,"Hamblen County_TN",27905,25095,2810,0.100698799
47065,"Hamilton County_TN",176911,162818,14093,0.079661525
47067,"Hancock County_TN",2548,2240,308,0.120879121
47069,"Hardeman County_TN",10149,8256,1893,0.186520839
47071,"Hardin County_TN",10964,9438,1526,0.13918278
47073,"Hawkins County_TN",24318,21893,2425,0.099720372
47075,"Haywood County_TN",8035,7194,841,0.104667082
47077,"Henderson County_TN",12267,11115,1152,0.093910492
47079,"Henry County_TN",13939,12592,1347,0.09663534
47081,"Hickman County_TN",10274,9388,886,0.086237103
47083,"Houston County_TN",3262,2997,265,0.081238504
47085,"Humphreys County_TN",7755,7067,688,0.088716957
47087,"Jackson County_TN",4494,3842,652,0.145082332
47089,"Jefferson County_TN",25314,23000,2314,0.091411867
47091,"Johnson County_TN",6643,6048,595,0.089567966
47093,"Knox County_TN",230298,215253,15045,0.065328401
47095,"Lake County_TN",2046,1840,206,0.100684262
47097,"Lauderdale County_TN",10503,9099,1404,0.133676093
47099,"Lawrence County_TN",18615,16607,2008,0.107869997
47101,"Lewis County_TN",5261,4858,403,0.076601407
47103,"Lincoln County_TN",15408,14232,1176,0.076323988
47105,"Loudon County_TN",21850,19909,1941,0.088832952
47107,"McMinn County_TN",22896,20767,2129,0.092985674
47109,"McNairy County_TN",10456,8901,1555,0.148718439
47111,"Macon County_TN",10430,9657,773,0.074113135
47113,"Madison County_TN",46979,43039,3940,0.08386726
47115,"Marion County_TN",12746,11895,851,0.066766044
47117,"Marshall County_TN",14887,13637,1250,0.083965876
47119,"Maury County_TN",42049,38831,3218,0.076529763
47121,"Meigs County_TN",4594,3907,687,0.149542882
47123,"Monroe County_TN",18492,16178,2314,0.125135194
47125,"Montgomery County_TN",80982,73139,7843,0.096848682
47127,"Moore County_TN",3258,3045,213,0.065377532
47129,"Morgan County_TN",7533,6893,640,0.084959511
47131,"Obion County_TN",14161,12572,1589,0.11220959
47133,"Overton County_TN",9191,8479,712,0.077467087
47135,"Perry County_TN",3116,2819,297,0.095314506
47137,"Pickett County_TN",2278,2166,112,0.049165935
47139,"Polk County_TN",7178,6397,781,0.108804681
47141,"Putnam County_TN",33129,30346,2783,0.08400495
47143,"Rhea County_TN",14057,12496,1561,0.111047877
47145,"Roane County_TN",22834,20586,2248,0.09844968
47147,"Robertson County_TN",34487,31579,2908,0.084321628
47149,"Rutherford County_TN",152065,141737,10328,0.067918324
47151,"Scott County_TN",9061,7780,1281,0.141375124
47153,"Sequatchie County_TN",6240,5676,564,0.090384615
47155,"Sevier County_TN",48379,44811,3568,0.073751008
47157,"Shelby County_TN",473992,425295,48697,0.102738021
47159,"Smith County_TN",8568,8121,447,0.052170868
47161,"Stewart County_TN",5359,4818,541,0.10095167
47163,"Sullivan County_TN",72272,66313,5959,0.082452402
47165,"Sumner County_TN",87485,82224,5261,0.060136023
47167,"Tipton County_TN",30444,27209,3235,0.106260675
47169,"Trousdale County_TN",3771,3376,395,0.104746752
47171,"Unicoi County_TN",7490,6462,1028,0.137249666
47173,"Union County_TN",7504,6792,712,0.094882729
47175,"Van Buren County_TN",2497,2218,279,0.111734081
47177,"Warren County_TN",17718,16304,1414,0.079805847
47179,"WA County_TN",60990,57193,3797,0.062256108
47181,"Wayne County_TN",6494,5703,791,0.121804743
47183,"Weakley County_TN",16151,14342,1809,0.112005449
47185,"White County_TN",10913,9769,1144,0.104829103
47187,"Williamson County_TN",102191,97869,4322,0.042293353
47189,"Wilson County_TN",63194,59107,4087,0.064673861
48001,"Anderson County_TX",20754,19859,895,0.043124217
48003,"Andrews County_TX",8245,7923,322,0.039053972
48005,"Angelina County_TX",39794,36182,3612,0.090767452
48007,"Aransas County_TX",10153,9464,689,0.067861716
48009,"Archer County_TX",4372,4239,133,0.03042086
48011,"Armstrong County_TX",965,954,11,0.011398964
48013,"Atascosa County_TX",21364,19975,1389,0.065015915
48015,"Austin County_TX",14371,13483,888,0.061791107
48017,"Bailey County_TX",3334,3191,143,0.042891422
48019,"Bandera County_TX",9466,9010,456,0.048172407
48021,"Bastrop County_TX",35852,32343,3509,0.097874596
48023,"Baylor County_TX",1507,1486,21,0.01393497
48025,"Bee County_TX",11241,10451,790,0.070278445
48027,"Bell County_TX",140938,127550,13388,0.094992124
48029,"Bexar County_TX",890280,824123,66157,0.074310329
48031,"Blanco County_TX",4989,4670,319,0.063940669
48033,"Borden County_TX",284,282,2,0.007042254
48035,"Bosque County_TX",7776,7165,611,0.078575103
48037,"Bowie County_TX",39300,35959,3341,0.085012723
48039,"Brazoria County_TX",163038,154290,8748,0.053656203
48041,"Brazos County_TX",105050,98294,6756,0.064312232
48043,"Brewster County_TX",4612,4385,227,0.049219428
48045,"Briscoe County_TX",794,757,37,0.046599496
48047,"Brooks County_TX",3011,2416,595,0.197608768
48049,"Brown County_TX",15688,15006,682,0.043472718
48051,"Burleson County_TX",7944,7352,592,0.074521652
48053,"Burnet County_TX",19671,18673,998,0.050734584
48055,"Caldwell County_TX",17612,16693,919,0.052180332
48057,"Calhoun County_TX",10145,9416,729,0.071858058
48059,"Callahan County_TX",5384,5092,292,0.05423477
48061,"Cameron County_TX",164483,148011,16472,0.100144088
48063,"Camp County_TX",5510,5039,471,0.085480944
48065,"Carson County_TX",2951,2902,49,0.016604541
48067,"Cass County_TX",13182,11964,1218,0.092398726
48069,"Castro County_TX",3480,3316,164,0.047126437
48071,"Chambers County_TX",16448,15166,1282,0.077942607
48073,"Cherokee County_TX",21078,19729,1349,0.06400038
48075,"Childress County_TX",2743,2600,143,0.052132701
48077,"Clay County_TX",4939,4605,334,0.067625025
48079,"Cochran County_TX",1289,1180,109,0.084561676
48081,"Coke County_TX",1557,1508,49,0.031470777
48083,"Coleman County_TX",3523,3235,288,0.08174851
48085,"Collin County_TX",467243,444189,23054,0.049340493
48087,"Collingsworth County_TX",1419,1345,74,0.052149401
48089,"CO County_TX",9568,9169,399,0.041701505
48091,"Comal County_TX",57007,54190,2817,0.049414984
48093,"Comanche County_TX",5590,5338,252,0.045080501
48095,"Concho County_TX",989,961,28,0.028311426
48097,"Cooke County_TX",19359,18012,1347,0.06958004
48099,"Coryell County_TX",25068,22684,2384,0.095101324
48101,"Cottle County_TX",665,615,50,0.07518797
48103,"Crane County_TX",2089,1980,109,0.052178076
48105,"Crockett County_TX",1884,1851,33,0.017515924
48107,"Crosby County_TX",2754,2478,276,0.100217865
48109,"Culberson County_TX",1091,1020,71,0.06507791
48111,"Dallam County_TX",3582,3381,201,0.056113903
48113,"Dallas County_TX",1289396,1191958,97438,0.075568716
48115,"Dawson County_TX",5353,4844,509,0.095086867
48117,"Deaf Smith County_TX",8984,8501,483,0.053762244
48119,"Delta County_TX",2119,1830,289,0.136385087
48121,"Denton County_TX",411349,387884,23465,0.057044019
48123,"DeWitt County_TX",8509,7927,582,0.068398167
48125,"Dickens County_TX",861,744,117,0.135888502
48127,"Dimmit County_TX",4692,4210,482,0.102728048
48129,"Donley County_TX",1468,1411,57,0.038828338
48131,"Duval County_TX",4866,4336,530,0.10891903
48133,"Eastland County_TX",7118,6803,315,0.044254004
48135,"Ector County_TX",74010,70130,3880,0.052425348
48137,"Edwards County_TX",959,912,47,0.049009385
48139,"Ellis County_TX",79881,74703,5178,0.064821422
48141,"El Paso County_TX",357775,327744,30031,0.083938229
48143,"Erath County_TX",20109,19275,834,0.041473967
48145,"Falls County_TX",6539,6068,471,0.072029362
48147,"Fannin County_TX",14207,13259,948,0.066727669
48149,"Fayette County_TX",11886,11669,217,0.018256773
48151,"Fisher County_TX",1905,1767,138,0.072440945
48153,"Floyd County_TX",2825,2600,225,0.079646018
48155,"Foard County_TX",494,446,48,0.097165992
48157,"Fort Bend County_TX",331602,314534,17068,0.051471342
48159,"Franklin County_TX",4613,4309,304,0.065900715
48161,"Freestone County_TX",8275,7868,407,0.04918429
48163,"Frio County_TX",6981,6618,363,0.051998281
48165,"Gaines County_TX",8194,7868,326,0.039785209
48167,"Galveston County_TX",155269,143681,11588,0.074631768
48169,"Garza County_TX",2059,2018,41,0.019912579
48171,"Gillespie County_TX",12049,11230,819,0.067972446
48173,"Glasscock County_TX",512,499,13,0.025390625
48175,"Goliad County_TX",3266,2962,304,0.09308022
48177,"Gonzales County_TX",9007,8422,585,0.064949484
48179,"Gray County_TX",9983,9444,539,0.053991786
48181,"Grayson County_TX",59472,54835,4637,0.077969465
48183,"Gregg County_TX",58874,55402,3472,0.058973401
48185,"Grimes County_TX",10609,9951,658,0.062022811
48187,"Guadalupe County_TX",70862,66822,4040,0.057012221
48189,"Hale County_TX",15514,14265,1249,0.080507928
48191,"Hall County_TX",1372,1214,158,0.11516035
48193,"Hamilton County_TX",3484,3279,205,0.058840413
48195,"Hansford County_TX",2692,2629,63,0.023402675
48197,"Hardeman County_TX",1775,1671,104,0.058591549
48199,"Hardin County_TX",25336,23933,1403,0.05537575
48201,"Harris County_TX",2250578,2081889,168689,0.074953634
48203,"Harrison County_TX",31040,28650,2390,0.076997423
48205,"Hartley County_TX",2340,2290,50,0.021367521
48207,"Haskell County_TX",2393,2227,166,0.069368993
48209,"Hays County_TX",93452,87233,6219,0.066547532
48211,"Hemphill County_TX",1881,1812,69,0.036682616
48213,"Henderson County_TX",32999,30441,2558,0.077517501
48215,"Hidalgo County_TX",330701,298030,32671,0.09879317
48217,"Hill County_TX",15660,14271,1389,0.088697318
48219,"Hockley County_TX",11466,10729,737,0.064276993
48221,"Hood County_TX",23380,22208,1172,0.050128315
48223,"Hopkins County_TX",16392,15235,1157,0.070583211
48225,"Houston County_TX",8220,7694,526,0.063990268
48227,"Howard County_TX",14881,13924,957,0.064310194
48229,"Hudspeth County_TX",1210,1141,69,0.057024793
48231,"Hunt County_TX",40188,35598,4590,0.114213198
48233,"Hutchinson County_TX",9866,9347,519,0.052604906
48235,"Irion County_TX",842,805,37,0.043942993
48237,"Jack County_TX",3545,3348,197,0.055571227
48239,"Jackson County_TX",6595,6251,344,0.052160728
48241,"Jasper County_TX",13936,12347,1589,0.11402124
48243,"Jeff Davis County_TX",1156,1074,82,0.070934256
48245,"Jefferson County_TX",113186,103203,9983,0.088199954
48247,"Jim Hogg County_TX",2139,1786,353,0.165030388
48249,"Jim Wells County_TX",17859,16674,1185,0.066353099
48251,"Johnson County_TX",74386,68950,5436,0.073078267
48253,"Jones County_TX",5222,5003,219,0.041937955
48255,"Karnes County_TX",5517,5251,266,0.048214609
48257,"Kaufman County_TX",54090,49359,4731,0.087465336
48259,"Kendall County_TX",17378,16597,781,0.044941881
48261,"Kenedy County_TX",185,185,0,0
48263,"Kent County_TX",404,398,6,0.014851485
48265,"Kerr County_TX",22317,20523,1794,0.080387149
48267,"Kimble County_TX",2305,2129,176,0.076355748
48269,"King County_TX",175,166,9,0.051428571
48271,"Kinney County_TX",1398,1213,185,0.132331903
48273,"Kleberg County_TX",15256,13466,1790,0.117330886
48275,"Knox County_TX",1651,1534,117,0.070866142
48277,"Lamar County_TX",22623,20953,1670,0.07381868
48279,"Lamb County_TX",6084,5709,375,0.061637081
48281,"Lampasas County_TX",9021,8245,776,0.086021505
48283,"La Salle County_TX",2511,2307,204,0.081242533
48285,"Lavaca County_TX",9304,8929,375,0.040305245
48287,"Lee County_TX",8170,7706,464,0.056793146
48289,"Leon County_TX",7212,6673,539,0.07473655
48291,"Liberty County_TX",31376,27767,3609,0.115024222
48293,"Limestone County_TX",10224,9384,840,0.082159624
48295,"Lipscomb County_TX",1749,1662,87,0.04974271
48297,"Live Oak County_TX",4324,4140,184,0.042553191
48299,"Llano County_TX",7798,7348,450,0.057707104
48301,"Loving County_TX",73,62,11,0.150684932
48303,"Lubbock County_TX",150794,141493,9301,0.061680173
48305,"Lynn County_TX",2704,2409,295,0.109097633
48307,"McCulloch County_TX",3894,3727,167,0.042886492
48309,"McLennan County_TX",114870,107737,7133,0.062096283
48311,"McMullen County_TX",377,324,53,0.140583554
48313,"Madison County_TX",4446,4194,252,0.056680162
48315,"Marion County_TX",4283,3940,343,0.080084053
48317,"Martin County_TX",2428,2342,86,0.035420099
48319,"Mason County_TX",2165,2018,147,0.067898383
48321,"Matagorda County_TX",16953,15874,1079,0.063646552
48323,"Maverick County_TX",23361,20309,3052,0.130645092
48325,"Medina County_TX",21000,19610,1390,0.066190476
48327,"Menard County_TX",869,797,72,0.082853855
48329,"Midland County_TX",79469,76743,2726,0.034302684
48331,"Milam County_TX",10188,9212,976,0.095798979
48333,"Mills County_TX",1957,1887,70,0.035769034
48335,"Mitchell County_TX",3128,2955,173,0.055306905
48337,"Montague County_TX",8774,8193,581,0.066218372
48339,"Montgomery County_TX",245208,230258,14950,0.060968647
48341,"Moore County_TX",11170,10714,456,0.040823635
48343,"Morris County_TX",5253,4588,665,0.126594327
48345,"Motley County_TX",516,459,57,0.110465116
48347,"Nacogdoches County_TX",30244,27638,2606,0.086165851
48349,"Navarro County_TX",22635,20159,2476,0.109388116
48351,"Newton County_TX",5586,4911,675,0.120837809
48353,"Nolan County_TX",6934,6403,531,0.076579175
48355,"Nueces County_TX",174481,162895,11586,0.066402646
48357,"Ochiltree County_TX",5359,5081,278,0.05187535
48359,"Oldham County_TX",835,773,62,0.074251497
48361,"Orange County_TX",38866,35616,3250,0.083620645
48363,"Palo Pinto County_TX",12310,11291,1019,0.082778229
48365,"Panola County_TX",10773,10154,619,0.057458461
48367,"Parker County_TX",59886,56235,3651,0.060965835
48369,"Parmer County_TX",4838,4665,173,0.035758578
48371,"Pecos County_TX",6775,6447,328,0.048413284
48373,"Polk County_TX",18083,16267,1816,0.100425814
48375,"Potter County_TX",56417,53420,2997,0.053122286
48377,"Presidio County_TX",2886,2610,276,0.095634096
48379,"Rains County_TX",4851,4468,383,0.078952793
48381,"Randall County_TX",67913,65270,2643,0.038917438
48383,"Reagan County_TX",1818,1778,40,0.0220022
48385,"Real County_TX",1132,996,136,0.120141343
48387,"Red River County_TX",5063,4697,366,0.072289157
48389,"Reeves County_TX",5110,4768,342,0.066927593
48391,"Refugio County_TX",3318,3096,222,0.066907776
48393,"Roberts County_TX",431,423,8,0.018561485
48395,"Robertson County_TX",7461,6776,685,0.091810749
48397,"Rockwall County_TX",43877,41300,2577,0.058732365
48399,"Runnels County_TX",4444,4292,152,0.03420342
48401,"Rusk County_TX",22310,21219,1091,0.048901838
48403,"Sabine County_TX",3278,2882,396,0.120805369
48405,"San Augustine County_TX",2674,2237,437,0.16342558
48407,"San Jacinto County_TX",11410,9976,1434,0.125679229
48409,"San Patricio County_TX",30201,28627,1574,0.05211748
48411,"San Saba County_TX",2449,2329,120,0.048999592
48413,"Schleicher County_TX",1563,1499,64,0.040946897
48415,"Scurry County_TX",7624,7371,253,0.03318468
48417,"Shackelford County_TX",1561,1502,59,0.037796284
48419,"Shelby County_TX",11033,10162,871,0.078944983
48421,"Sherman County_TX",1554,1497,57,0.036679537
48423,"Smith County_TX",103271,95841,7430,0.071946626
48425,"Somervell County_TX",3960,3878,82,0.020707071
48427,"Starr County_TX",24382,21006,3376,0.1384628
48429,"Stephens County_TX",3958,3805,153,0.038655887
48431,"Sterling County_TX",585,583,2,0.003418803
48433,"Stonewall County_TX",594,553,41,0.069023569
48435,"Sutton County_TX",1851,1771,80,0.043219881
48437,"Swisher County_TX",2974,2784,190,0.063887021
48439,"Tarrant County_TX",993242,924741,68501,0.06896708
48441,"Taylor County_TX",64516,60708,3808,0.059024118
48443,"Terrell County_TX",431,415,16,0.03712297
48445,"Terry County_TX",5101,4767,334,0.065477357
48447,"Throckmorton County_TX",704,686,18,0.025568182
48449,"Titus County_TX",14992,13867,1125,0.075040021
48451,"Tom Green County_TX",54057,51528,2529,0.04678395
48453,"Travis County_TX",637542,599597,37945,0.059517647
48455,"Trinity County_TX",5465,4922,543,0.099359561
48457,"Tyler County_TX",8171,7230,941,0.115163383
48459,"Upshur County_TX",18297,16849,1448,0.079138657
48461,"Upton County_TX",1386,1326,60,0.043290043
48463,"Uvalde County_TX",11756,10801,955,0.081235114
48465,"Val Verde County_TX",20133,18261,1872,0.092981672
48467,"Van Zandt County_TX",23273,21856,1417,0.060886005
48469,"Victoria County_TX",44383,41513,2870,0.064664399
48471,"Walker County_TX",23648,22612,1036,0.043809202
48473,"Waller County_TX",21940,20127,1813,0.082634458
48475,"Ward County_TX",4874,4661,213,0.043701272
48477,"WA County_TX",15146,14380,766,0.050574409
48479,"Webb County_TX",105329,98996,6333,0.060125891
48481,"Wharton County_TX",19904,18584,1320,0.066318328
48483,"Wheeler County_TX",2797,2688,109,0.038970325
48485,"Wichita County_TX",58635,55053,3582,0.061089793
48487,"Wilbarger County_TX",6462,5977,485,0.075054163
48489,"Willacy County_TX",6062,5365,697,0.114978555
48491,"Williamson County_TX",248207,233418,14789,0.059583332
48493,"Wilson County_TX",21776,20521,1255,0.057632256
48495,"Winkler County_TX",3356,3271,85,0.025327771
48497,"Wise County_TX",29362,27154,2208,0.075199237
48499,"Wood County_TX",17415,15868,1547,0.088831467
48501,"Yoakum County_TX",3857,3546,311,0.080632616
48503,"Young County_TX",8784,8288,496,0.056466302
48505,"Zapata County_TX",5905,5184,721,0.122099915
48507,"Zavala County_TX",4869,4276,593,0.121790922
49001,"Beaver County_UT",2994,2881,113,0.037742151
49003,"Box Elder County_UT",22984,21534,1450,0.063087365
49005,"Cache County_UT",57768,54566,3202,0.055428611
49007,"Carbon County_UT",9931,9197,734,0.073909979
49009,"Daggett County_UT",232,222,10,0.043103448
49011,"Davis County_UT",154345,147875,6470,0.041919077
49013,"Duchesne County_UT",8304,7875,429,0.05166185
49015,"Emery County_UT",4442,4188,254,0.05718145
49017,"Garfield County_UT",2187,2000,187,0.085505258
49019,"Grand County_UT",5103,4741,362,0.070938664
49021,"Iron County_UT",21948,19636,2312,0.105339894
49023,"Juab County_UT",4597,4422,175,0.038068305
49025,"Kane County_UT",3442,3201,241,0.070017432
49027,"Millard County_UT",5745,5499,246,0.042819843
49029,"Morgan County_UT",4503,4234,269,0.059737952
49031,"Piute County_UT",701,653,48,0.068473609
49033,"Rich County_UT",779,731,48,0.061617458
49035,"Salt Lake County_UT",569241,536170,33071,0.058096659
49037,"San Juan County_UT",5489,5026,463,0.084350519
49039,"Sanpete County_UT",10968,10060,908,0.082786287
49041,"Sevier County_UT",8979,8449,530,0.059026618
49043,"Summit County_UT",21425,20741,684,0.031925321
49045,"Tooele County_UT",28336,26337,1999,0.070546302
49047,"Uintah County_UT",16180,15359,821,0.050741656
49049,"UT County_UT",255051,241085,13966,0.054757676
49051,"Wasatch County_UT",13069,12451,618,0.047287474
49053,"WA County_UT",62606,57785,4821,0.077005399
49055,"Wayne County_UT",1281,1254,27,0.021077283
49057,"Weber County_UT",116886,109474,7412,0.063412214
50001,"Addison County_VT",20728,19530,1198,0.057796218
50003,"Bennington County_VT",19108,18014,1094,0.057253506
50005,"Caledonia County_VT",15926,14773,1153,0.072397338
50007,"Chittenden County_VT",93982,89268,4714,0.050158541
50009,"Essex County_VT",2962,2683,279,0.094193113
50011,"Franklin County_VT",26730,25416,1314,0.049158249
50013,"Grand Isle County_VT",3994,3697,297,0.074361542
50015,"Lamoille County_VT",13739,13147,592,0.043089017
50017,"Orange County_VT",16032,15314,718,0.044785429
50019,"Orleans County_VT",12889,12168,721,0.055939173
50021,"Rutland County_VT",32237,30125,2112,0.065514781
50023,"WA County_VT",33380,31774,1606,0.048112642
50025,"Windham County_VT",23966,22336,1630,0.068013018
50027,"Windsor County_VT",30016,28487,1529,0.050939499
51001,"Accomack County_VA",15335,14296,1039,0.067753505
51003,"Albemarle County_VA",50089,48206,1883,0.037593084
51005,"Alleghany County_VA",6888,6539,349,0.050667828
51007,"Amelia County_VA",5984,5686,298,0.049799465
51009,"Amherst County_VA",15706,14663,1043,0.066407742
51011,"Appomattox County_VA",6991,6532,459,0.065655843
51013,"Arlington County_VA",146704,141305,5399,0.036801996
51015,"Augusta County_VA",35978,34285,1693,0.047056535
51017,"Bath County_VA",2457,2310,147,0.05982906
51019,"Bedford County_VA",37971,35756,2215,0.058333992
51021,"Bland County_VA",2743,2504,239,0.087130879
51023,"Botetourt County_VA",17032,16257,775,0.045502583
51025,"Brunswick County_VA",7373,6601,772,0.104706361
51027,"Buchanan County_VA",7963,7120,843,0.105864624
51029,"Buckingham County_VA",7218,6406,812,0.112496536
51031,"Campbell County_VA",27787,26131,1656,0.059596214
51033,"Caroline County_VA",14812,13539,1273,0.085943829
51035,"Carroll County_VA",13966,13033,933,0.066805098
51036,"Charles City County_VA",3620,3323,297,0.082044199
51037,"Charlotte County_VA",5538,5266,272,0.049115204
51041,"Chesterfield County_VA",176864,164842,12022,0.067973132
51043,"Clarke County_VA",7347,6908,439,0.05975228
51045,"Craig County_VA",2190,2101,89,0.040639269
51047,"Culpeper County_VA",23849,22103,1746,0.073210617
51049,"Cumberland County_VA",5082,4567,515,0.101338056
51051,"Dickenson County_VA",5478,5017,461,0.084154801
51053,"Dinwiddie County_VA",14014,12653,1361,0.097117169
51057,"Essex County_VA",5692,5211,481,0.084504568
51059,"Fairfax County_VA",634904,603966,30938,0.048728627
51061,"Fauquier County_VA",36338,34515,1823,0.050167868
51063,"Floyd County_VA",7951,7494,457,0.057477047
51065,"Fluvanna County_VA",12736,12076,660,0.051821608
51067,"Franklin County_VA",26825,25149,1676,0.062479031
51069,"Frederick County_VA",43243,40973,2270,0.052494045
51071,"Giles County_VA",7890,7510,380,0.048162231
51073,"Gloucester County_VA",18484,17612,872,0.047175936
51075,"Goochland County_VA",10868,10325,543,0.049963195
51077,"Grayson County_VA",6885,6262,623,0.090486565
51079,"Greene County_VA",9641,8932,709,0.073540089
51081,"Greensville County_VA",3596,3365,231,0.064238042
51083,"Halifax County_VA",15393,14234,1159,0.075293965
51085,"Hanover County_VA",55105,52677,2428,0.044061337
51087,"Henrico County_VA",176723,164877,11846,0.067031456
51089,"Henry County_VA",23852,21466,2386,0.10003354
51091,"Highland County_VA",1017,1006,11,0.010816126
51093,"Isle of Wight County_VA",18810,17246,1564,0.083147262
51095,"James City County_VA",33377,31685,1692,0.050693591
51097,"King and Queen County_VA",3528,3335,193,0.054705215
51099,"King George County_VA",13066,12096,970,0.074238482
51101,"King William County_VA",8425,7972,453,0.053768546
51103,"Lancaster County_VA",5092,4690,402,0.078947368
51105,"Lee County_VA",9029,7942,1087,0.120389855
51107,"Loudoun County_VA",194311,186474,7837,0.040332251
51109,"Louisa County_VA",17491,16077,1414,0.080841576
51111,"Lunenburg County_VA",4880,4523,357,0.073155738
51113,"Madison County_VA",6388,5965,423,0.066217909
51115,"Mathews County_VA",4036,3901,135,0.033448959
51117,"Mecklenburg County_VA",13383,12460,923,0.068968094
51119,"Middlesex County_VA",4702,4404,298,0.063377286
51121,"Montgomery County_VA",48332,45648,2684,0.055532566
51125,"Nelson County_VA",7096,6694,402,0.056651635
51127,"New Kent County_VA",10540,9896,644,0.061100569
51131,"Northampton County_VA",5335,4830,505,0.094657919
51133,"Northumberland County_VA",5501,5021,480,0.087256862
51135,"Nottoway County_VA",6327,5644,683,0.107950055
51137,"Orange County_VA",16316,15024,1292,0.079186075
51139,"Page County_VA",11447,10379,1068,0.093299554
51141,"Patrick County_VA",7599,6971,628,0.082642453
51143,"Pittsylvania County_VA",30112,27803,2309,0.076680393
51145,"Powhatan County_VA",13988,13301,687,0.049113526
51147,"Prince Edward County_VA",9430,8771,659,0.069883351
51149,"Prince George County_VA",16021,14315,1706,0.106485238
51153,"Prince William County_VA",236838,223939,12899,0.054463388
51155,"Pulaski County_VA",16721,15480,1241,0.074218049
51157,"Rappahannock County_VA",3677,3570,107,0.02909981
51159,"Richmond County_VA",3502,3199,303,0.086521987
51161,"Roanoke County_VA",47797,45358,2439,0.051028307
51163,"Rockbridge County_VA",10212,9789,423,0.041421857
51165,"Rockingham County_VA",40284,38108,2176,0.054016483
51167,"Russell County_VA",11104,10211,893,0.08042147
51169,"Scott County_VA",9396,8509,887,0.094401873
51171,"Shenandoah County_VA",21275,19990,1285,0.06039953
51173,"Smyth County_VA",14190,13278,912,0.064270613
51175,"Southampton County_VA",8564,7948,616,0.071929005
51177,"Spotsylvania County_VA",66578,62469,4109,0.061717084
51179,"Stafford County_VA",68401,64619,3782,0.055291589
51181,"Surry County_VA",3595,3209,386,0.107371349
51183,"Sussex County_VA",2740,2551,189,0.068978102
51185,"Tazewell County_VA",18215,16752,1463,0.080318419
51187,"Warren County_VA",20142,18689,1453,0.072137821
51191,"WA County_VA",26265,24442,1823,0.069407957
51193,"Westmoreland County_VA",8221,7423,798,0.097068483
51195,"Wise County_VA",15435,13736,1699,0.110074506
51197,"Wythe County_VA",13968,12631,1337,0.095718786
51199,"York County_VA",32033,30160,1873,0.058470952
51510,"Alexandria city_VA",96946,92575,4371,0.045086956
51520,"Bristol city_VA",8180,7306,874,0.106845966
51530,"Buena Vista city_VA",3046,2824,222,0.072882469
51540,"Charlottesville city_VA",24668,23605,1063,0.043092265
51550,"Chesapeake city_VA",114491,105953,8538,0.074573547
51570,"Colonial Heights city_VA",8370,7672,698,0.08339307
51580,"Covington city_VA",2331,2160,171,0.073359073
51590,"Danville city_VA",19109,16682,2427,0.127008216
51595,"Emporia city_VA",2564,2074,490,0.191107644
51600,"Fairfax city_VA",13445,12724,721,0.053625883
51610,"Falls Church city_VA",7672,7347,325,0.042361835
51620,"Franklin city_VA",3975,3429,546,0.137358491
51630,"Fredericksburg city_VA",14696,13384,1312,0.089275993
51640,"Galax city_VA",3036,2842,194,0.063899868
51650,"Hampton city_VA",67464,60826,6638,0.098393217
51660,"Harrisonburg city_VA",25671,24011,1660,0.064664407
51670,"Hopewell city_VA",10365,9041,1324,0.127737578
51678,"Lexington city_VA",2139,2082,57,0.026647966
51680,"Lynchburg city_VA",37381,34404,2977,0.079639389
51683,"Manassas city_VA",23299,21549,1750,0.07511052
51685,"Manassas Park city_VA",8356,7991,365,0.043681187
51690,"Martinsville city_VA",5828,5156,672,0.115305422
51700,"Newport News city_VA",90814,82572,8242,0.090756932
51710,"Norfolk city_VA",114193,101764,12429,0.108842048
51720,"Norton city_VA",2037,1811,226,0.110947472
51730,"Petersburg city_VA",14821,12898,1923,0.12974833
51735,"Poquoson city_VA",6209,5932,277,0.044612659
51740,"Portsmouth city_VA",46434,41039,5395,0.116186415
51750,"Radford city_VA",7455,6797,658,0.088262911
51760,"Richmond city_VA",116151,104547,11604,0.099904435
51770,"Roanoke city_VA",50519,46331,4188,0.082899503
51775,"Salem city_VA",13138,12506,632,0.048104734
51790,"Staunton city_VA",11969,11297,672,0.056145041
51800,"Suffolk city_VA",43015,39589,3426,0.079646635
51810,"VA Beach city_VA",228859,214968,13891,0.060696761
51820,"Waynesboro city_VA",10156,9655,501,0.049330445
51830,"Williamsburg city_VA",6504,5953,551,0.084717097
51840,"Winchester city_VA",13657,12748,909,0.066559274
53001,"Adams County_WA",8514,7698,816,0.095842142
53003,"Asotin County_WA",10437,9439,998,0.095621347
53005,"Benton County_WA",88554,82427,6127,0.069189421
53007,"Chelan County_WA",35837,33140,2697,0.075257416
53009,"Clallam County_WA",30736,27697,3039,0.098874284
53011,"Clark County_WA",220146,201261,18885,0.08578398
53013,"Columbia County_WA",1737,1557,180,0.103626943
53015,"Cowlitz County_WA",45281,40418,4863,0.107396038
53017,"Douglas County_WA",19288,18034,1254,0.065014517
53019,"Ferry County_WA",2793,2452,341,0.122090942
53021,"Franklin County_WA",39079,36259,2820,0.072161519
53023,"Garfield County_WA",954,883,71,0.07442348
53025,"Grant County_WA",42615,38314,4301,0.100926904
53027,"Grays Harbor County_WA",30566,26197,4369,0.142936596
53029,"Island County_WA",34629,31525,3104,0.089635854
53031,"Jefferson County_WA",12725,11518,1207,0.094852652
53033,"King County_WA",1152753,1079601,73152,0.063458521
53035,"Kitsap County_WA",117176,107745,9431,0.080485765
53037,"Kittitas County_WA",21480,19811,1669,0.077700186
53039,"Klickitat County_WA",8349,7766,583,0.069828722
53041,"Lewis County_WA",33335,29297,4038,0.121133943
53043,"Lincoln County_WA",4253,4050,203,0.047731013
53045,"Mason County_WA",25443,22155,3288,0.129230044
53047,"Okanogan County_WA",18624,16969,1655,0.088863832
53049,"Pacific County_WA",7841,7141,700,0.089274327
53051,"Pend Oreille County_WA",4703,4217,486,0.103338295
53053,"Pierce County_WA",402348,365152,37196,0.092447334
53055,"San Juan County_WA",8110,7633,477,0.058816276
53057,"Skagit County_WA",56367,51761,4606,0.081714478
53059,"Skamania County_WA",5174,4742,432,0.083494395
53061,"Snohomish County_WA",397340,367655,29685,0.074709317
53063,"Spokane County_WA",231025,211522,19503,0.084419435
53065,"Stevens County_WA",17954,16259,1695,0.094407931
53067,"Thurston County_WA",130204,119123,11081,0.085104912
53069,"Wahkiakum County_WA",1396,1248,148,0.106017192
53071,"Walla Walla County_WA",27911,26112,1799,0.064454874
53073,"Whatcom County_WA",107074,98265,8809,0.082270206
53075,"Whitman County_WA",23748,21665,2083,0.087712649
53077,"Yakima County_WA",111184,101169,10015,0.09007591
54001,"Barbour County_WV",6976,6345,631,0.090452982
54003,"Berkeley County_WV",55320,49941,5379,0.097234273
54005,"Boone County_WV",8360,7592,768,0.091866029
54007,"Braxton County_WV",6165,5280,885,0.143552311
54009,"Brooke County_WV",11074,10360,714,0.064475348
54011,"Cabell County_WV",43049,40103,2946,0.068433645
54013,"Calhoun County_WV",3065,2511,554,0.180750408
54015,"Clay County_WV",3298,2891,407,0.123408126
54017,"Doddridge County_WV",3029,2831,198,0.065368108
54019,"Fayette County_WV",17440,15837,1603,0.091915138
54021,"Gilmer County_WV",3080,2791,289,0.093831169
54023,"Grant County_WV",5334,4974,360,0.067491564
54025,"Greenbrier County_WV",15205,14116,1089,0.071621177
54027,"Hampshire County_WV",9661,8878,783,0.081047511
54029,"Hancock County_WV",14270,13236,1034,0.072459706
54031,"Hardy County_WV",6653,6129,524,0.078761461
54033,"Harrison County_WV",31963,29587,2376,0.074335951
54035,"Jackson County_WV",11857,11050,807,0.068061061
54037,"Jefferson County_WV",28851,26418,2433,0.084329833
54039,"Kanawha County_WV",90805,84406,6399,0.070469688
54041,"Lewis County_WV",6748,6259,489,0.072465916
54043,"Lincoln County_WV",8057,7245,812,0.100781929
54045,"Logan County_WV",13197,11765,1432,0.10850951
54047,"McDowell County_WV",5339,4627,712,0.133358307
54049,"Marion County_WV",26741,25422,1319,0.049325007
54051,"Marshall County_WV",14542,13530,1012,0.069591528
54053,"Mason County_WV",10159,9116,1043,0.102667585
54055,"Mercer County_WV",24707,23443,1264,0.05115959
54057,"Mineral County_WV",11749,10716,1033,0.087922376
54059,"Mingo County_WV",9256,7951,1305,0.140989628
54061,"Monongalia County_WV",51340,48349,2991,0.058258668
54063,"Monroe County_WV",5767,5348,419,0.07265476
54065,"Morgan County_WV",8149,7144,1005,0.123328016
54067,"Nicholas County_WV",10723,9824,899,0.083838478
54069,"OH County_WV",21462,20291,1171,0.054561551
54071,"Pendleton County_WV",2980,2833,147,0.049328859
54073,"Pleasants County_WV",3175,2915,260,0.081889764
54075,"Pocahontas County_WV",3949,3723,226,0.057229678
54077,"Preston County_WV",14877,13842,1035,0.069570478
54079,"Putnam County_WV",26974,25964,1010,0.037443464
54081,"Raleigh County_WV",31054,29014,2040,0.06569202
54083,"Randolph County_WV",12684,11833,851,0.0670924
54085,"Ritchie County_WV",4174,3730,444,0.106372784
54087,"Roane County_WV",5367,4892,475,0.08850382
54089,"Summers County_WV",5396,4857,539,0.099888807
54091,"Taylor County_WV",7500,6784,716,0.095466667
54093,"Tucker County_WV",3304,3052,252,0.076271186
54095,"Tyler County_WV",3700,3296,404,0.109189189
54097,"Upshur County_WV",10526,9682,844,0.080182405
54099,"Wayne County_WV",16143,14542,1601,0.099176113
54101,"Webster County_WV",3455,2945,510,0.147612156
54103,"Wetzel County_WV",6040,5548,492,0.081456954
54105,"Wirt County_WV",2472,2265,207,0.083737864
54107,"Wood County_WV",40260,36778,3482,0.086487829
54109,"WY County_WV",7172,6451,721,0.100529838
55001,"Adams County_WI",8295,7457,838,0.101024714
55003,"Ashland County_WI",8116,7475,641,0.078979793
55005,"Barron County_WI",23683,22257,1426,0.060211966
55007,"Bayfield County_WI",7388,6859,529,0.071602599
55009,"Brown County_WI",138821,130354,8467,0.060992213
55011,"Buffalo County_WI",7283,7013,270,0.037072635
55013,"Burnett County_WI",6985,6464,521,0.074588404
55015,"Calumet County_WI",27527,26679,848,0.030806118
55017,"Chippewa County_WI",32746,31085,1661,0.050723753
55019,"Clark County_WI",16363,15579,784,0.047912974
55021,"Columbia County_WI",31284,29483,1801,0.057569365
55023,"Crawford County_WI",8012,7491,521,0.065027459
55025,"Dane County_WI",302073,287151,14922,0.049398655
55027,"Dodge County_WI",46121,43362,2759,0.059820906
55029,"Door County_WI",14038,13169,869,0.061903405
55031,"Douglas County_WI",22948,21340,1608,0.070071466
55033,"Dunn County_WI",23957,22494,1463,0.061067746
55035,"Eau Claire County_WI",57390,54079,3311,0.057692978
55037,"Florence County_WI",2092,1942,150,0.071701721
55039,"Fond du Lac County_WI",55822,52846,2976,0.053312314
55041,"Forest County_WI",3961,3559,402,0.101489523
55043,"Grant County_WI",27425,26157,1268,0.046235187
55045,"Green County_WI",20541,19815,726,0.035343946
55047,"Green Lake County_WI",9564,9016,548,0.057298202
55049,"IA County_WI",13040,12424,616,0.047239264
55051,"Iron County_WI",2754,2560,194,0.070442992
55053,"Jackson County_WI",9845,9294,551,0.055967496
55055,"Jefferson County_WI",46989,44424,2565,0.054587244
55057,"Juneau County_WI",12394,11520,874,0.070517993
55059,"Kenosha County_WI",88304,79753,8551,0.09683593
55061,"Kewaunee County_WI",10916,10404,512,0.046903628
55063,"La Crosse County_WI",65833,62292,3541,0.053787614
55065,"Lafayette County_WI",9029,8705,324,0.035884373
55067,"Langlade County_WI",9564,8779,785,0.082078628
55069,"Lincoln County_WI",14873,13973,900,0.060512338
55071,"Manitowoc County_WI",43276,40799,2477,0.057237268
55073,"Marathon County_WI",74061,69834,4227,0.057074574
55075,"Marinette County_WI",20497,18969,1528,0.074547495
55077,"Marquette County_WI",7366,6809,557,0.075617703
55078,"Menominee County_WI",1647,1403,244,0.148148148
55079,"Milwaukee County_WI",490919,445174,45745,0.093182378
55081,"Monroe County_WI",22381,20936,1445,0.064563692
55083,"Oconto County_WI",20188,19075,1113,0.055131761
55085,"Oneida County_WI",17672,16557,1115,0.06309416
55087,"Outagamie County_WI",100443,96532,3911,0.038937507
55089,"Ozaukee County_WI",47667,45522,2145,0.044999685
55091,"Pepin County_WI",3793,3618,175,0.046137622
55093,"Pierce County_WI",23410,22567,843,0.036010252
55095,"Polk County_WI",22635,21085,1550,0.068478021
55097,"Portage County_WI",39180,36371,2809,0.071694742
55099,"Price County_WI",6982,6662,320,0.04583214
55101,"Racine County_WI",100197,91796,8401,0.083844826
55103,"Richland County_WI",8753,8332,421,0.048097795
55105,"Rock County_WI",82908,75824,7084,0.085444107
55107,"Rusk County_WI",6868,6462,406,0.059114735
55109,"St. Croix County_WI",48110,45882,2228,0.046310538
55111,"Sauk County_WI",34445,32534,1911,0.05547975
55113,"Sawyer County_WI",7709,6957,752,0.09754832
55115,"Shawano County_WI",21430,20281,1149,0.053616426
55117,"Sheboygan County_WI",62797,59133,3664,0.058346736
55119,"Taylor County_WI",10678,10090,588,0.055066492
55121,"Trempealeau County_WI",15740,15166,574,0.036467598
55123,"Vernon County_WI",14010,13450,560,0.039971449
55125,"Vilas County_WI",9771,8986,785,0.080339781
55127,"Walworth County_WI",56113,52048,4065,0.072443106
55129,"Washburn County_WI",7366,6880,486,0.065978822
55131,"WA County_WI",75737,72365,3372,0.044522492
55133,"Waukesha County_WI",218670,209461,9209,0.042113687
55135,"Waupaca County_WI",27251,25703,1548,0.056805255
55137,"Waushara County_WI",11271,10458,813,0.07213202
55139,"Winnebago County_WI",90212,85970,4242,0.047022569
55141,"Wood County_WI",39024,36445,2579,0.066087536
56001,"Albany County_WY",21586,20577,1009,0.04674326
56003,"Big Horn County_WY",5530,5288,242,0.043761302
56005,"Campbell County_WY",27497,26387,1110,0.04036804
56007,"Carbon County_WY",8201,7851,350,0.042677722
56009,"Converse County_WY",7696,7303,393,0.051065489
56011,"Crook County_WY",3915,3754,161,0.041123883
56013,"Fremont County_WY",20329,18736,1593,0.078360962
56015,"Goshen County_WY",6523,6080,443,0.067913537
56017,"Hot Springs County_WY",2369,2292,77,0.032503166
56019,"Johnson County_WY",4459,4300,159,0.035658219
56021,"Laramie County_WY",48659,46206,2453,0.050412051
56023,"Lincoln County_WY",9319,8724,595,0.063848052
56025,"Natrona County_WY",43652,41415,2237,0.05124622
56027,"Niobrara County_WY",1132,1114,18,0.01590106
56029,"Park County_WY",15912,15305,607,0.03814731
56031,"Platte County_WY",4233,4133,100,0.023623907
56033,"Sheridan County_WY",14843,14336,507,0.034157515
56035,"Sublette County_WY",5860,5541,319,0.05443686
56037,"Sweetwater County_WY",24327,23010,1317,0.054137378
56039,"Teton County_WY",14681,14298,383,0.026088141
56041,"Uinta County_WY",10527,10064,463,0.043982141
56043,"Washakie County_WY",4176,3892,284,0.068007663
56045,"Weston County_WY",3525,3343,182,0.051631206
72001,"Adjuntas Municipio_Puerto Rico",6446,4093,2353,0.365032578
72003,"Aguada Municipio_Puerto Rico",15397,11540,3857,0.250503345
72005,"Aguadilla Municipio_Puerto Rico",19043,14616,4427,0.232473875
72007,"Aguas Buenas Municipio_Puerto Rico",8563,6459,2104,0.24570828
72009,"Aibonito Municipio_Puerto Rico",6282,5902,380,0.06049029
72011,"A�asco Municipio_Puerto Rico",9749,8286,1463,0.150066674
72013,"Arecibo Municipio_Puerto Rico",28617,23545,5072,0.177237306
72015,"Arroyo Municipio_Puerto Rico",5187,4000,1187,0.228841334
72017,"Barceloneta Municipio_Puerto Rico",6505,5392,1113,0.171099154
72019,"Barranquitas Municipio_Puerto Rico",6693,6235,458,0.068429703
72021,"Bayam�n Municipio_Puerto Rico",81750,68598,13152,0.160880734
72023,"Cabo Rojo Municipio_Puerto Rico",14079,12421,1658,0.117764046
72025,"Caguas Municipio_Puerto Rico",57202,48083,9119,0.159417503
72027,"Camuy Municipio_Puerto Rico",11328,8899,2429,0.214424435
72029,"Can�vanas Municipio_Puerto Rico",19114,14797,4317,0.225855394
72031,"Carolina Municipio_Puerto Rico",74798,63979,10819,0.144642905
72033,"Cata�o Municipio_Puerto Rico",11385,7883,3502,0.307597716
72035,"Cayey Municipio_Puerto Rico",18153,15825,2328,0.128243266
72037,"Ceiba Municipio_Puerto Rico",4255,3738,517,0.121504113
72039,"Ciales Municipio_Puerto Rico",4218,3472,746,0.176861072
72041,"Cidra Municipio_Puerto Rico",17384,15006,2378,0.136792453
72043,"Coamo Municipio_Puerto Rico",13076,11567,1509,0.115402264
72045,"Comer�o Municipio_Puerto Rico",6014,4776,1238,0.20585301
72047,"Corozal Municipio_Puerto Rico",10402,8001,2401,0.230820996
72049,"Culebra Municipio_Puerto Rico",683,661,22,0.032210835
72051,"Dorado Municipio_Puerto Rico",14866,11988,2878,0.193596125
72053,"Fajardo Municipio_Puerto Rico",14356,10747,3609,0.251393146
72054,"FL Municipio_Puerto Rico",3727,3140,587,0.157499329
72055,"Gu�nica Municipio_Puerto Rico",5254,3824,1430,0.272173582
72057,"Guayama Municipio_Puerto Rico",11754,9713,2041,0.173643015
72059,"Guayanilla Municipio_Puerto Rico",5943,4603,1340,0.225475349
72061,"Guaynabo Municipio_Puerto Rico",42790,37469,5321,0.124351484
72063,"Gurabo Municipio_Puerto Rico",20227,17525,2702,0.133583824
72065,"Hatillo Municipio_Puerto Rico",14555,12623,1932,0.132737891
72067,"Hormigueros Municipio_Puerto Rico",6315,4887,1428,0.226128266
72069,"Humacao Municipio_Puerto Rico",18334,15802,2532,0.138104069
72071,"Isabela Municipio_Puerto Rico",13109,10452,2657,0.202685178
72073,"Jayuya Municipio_Puerto Rico",4994,3412,1582,0.316780136
72075,"Juana D�az Municipio_Puerto Rico",17992,14900,3092,0.171854157
72077,"Juncos Municipio_Puerto Rico",15212,11559,3653,0.240139364
72079,"Lajas Municipio_Puerto Rico",6010,4954,1056,0.175707155
72081,"Lares Municipio_Puerto Rico",9582,6205,3377,0.352431643
72083,"Las Mar�as Municipio_Puerto Rico",2596,2477,119,0.045839753
72085,"Las Piedras Municipio_Puerto Rico",13027,10102,2925,0.224533661
72087,"Lo�za Municipio_Puerto Rico",11441,8443,2998,0.262040031
72089,"Luquillo Municipio_Puerto Rico",7867,5626,2241,0.284860811
72091,"Manat� Municipio_Puerto Rico",13903,11272,2631,0.189239732
72093,"Maricao Municipio_Puerto Rico",1679,1500,179,0.106611078
72095,"Maunabo Municipio_Puerto Rico",3411,2459,952,0.279097039
72097,"Mayag�ez Municipio_Puerto Rico",27282,21048,6234,0.228502309
72099,"Moca Municipio_Puerto Rico",11999,9245,2754,0.229519127
72101,"Morovis Municipio_Puerto Rico",10274,7740,2534,0.246642009
72103,"Naguabo Municipio_Puerto Rico",8238,7342,896,0.108764263
72105,"Naranjito Municipio_Puerto Rico",9363,7315,2048,0.218733312
72107,"Orocovis Municipio_Puerto Rico",6617,4552,2065,0.312074958
72109,"Patillas Municipio_Puerto Rico",5357,3884,1473,0.274967332
72111,"Pe�uelas Municipio_Puerto Rico",7327,5412,1915,0.261362085
72113,"Ponce Municipio_Puerto Rico",52139,41711,10428,0.200003836
72115,"Quebradillas Municipio_Puerto Rico",7492,6284,1208,0.161238655
72117,"Rinc�n Municipio_Puerto Rico",5350,4406,944,0.176448598
72119,"R�o Grande Municipio_Puerto Rico",22376,17033,5343,0.238782624
72121,"Sabana Grande Municipio_Puerto Rico",7052,5339,1713,0.242909813
72123,"Salinas Municipio_Puerto Rico",8877,7804,1073,0.120874169
72125,"San Germ�n Municipio_Puerto Rico",9447,8803,644,0.068169789
72127,"San Juan Municipio_Puerto Rico",158109,133186,24923,0.15763176
72129,"San Lorenzo Municipio_Puerto Rico",13446,11327,2119,0.157593336
72131,"San Sebasti�n Municipio_Puerto Rico",12436,8785,3651,0.293583146
72133,"Santa Isabel Municipio_Puerto Rico",7856,6895,961,0.122326884
72135,"Toa Alta Municipio_Puerto Rico",31742,26760,4982,0.156952933
72137,"Toa Baja Municipio_Puerto Rico",37059,30020,7039,0.189940365
72139,"Trujillo Alto Municipio_Puerto Rico",30467,28059,2408,0.079036334
72141,"Utuado Municipio_Puerto Rico",9575,6819,2756,0.287832898
72143,"Vega Alta Municipio_Puerto Rico",12519,9804,2715,0.216870357
72145,"Vega Baja Municipio_Puerto Rico",16107,13660,2447,0.151921525
72147,"Vieques Municipio_Puerto Rico",3258,2860,398,0.122160835
72149,"Villalba Municipio_Puerto Rico",9169,6795,2374,0.258915912
72151,"Yabucoa Municipio_Puerto Rico",10675,8083,2592,0.242810304
72153,"Yauco Municipio_Puerto Rico",12247,8923,3324,0.271413407
